day,time,numberOfModifiedFiles,insertions,deletions,totalLines,complexity,badCommit
3,906,669,71704,0,71704,0.6448204852717343,1
3,1144,1,11,12,23,0.0,0
3,1160,1,6,3,9,0.0,0
3,1181,1,15,16,31,0.0,0
3,1191,1,41,33,74,0.0,0
4,345,1,4,0,4,1.0,0
4,368,1,2,0,2,0.0,1
4,461,5,80,35,115,1.0,1
0,517,1,11,10,21,1.0,0
1,394,1,27,15,42,1.0,0
1,489,1,39,22,61,1.0,0
1,558,1,74,91,165,1.0,1
2,101,115,2385,132,2517,0.787,1
2,138,71,397,1615,2012,0.26264044943820225,0
2,184,1,110,0,110,1.0,0
2,287,20,28,190,218,0.35106382978723405,0
2,354,1,77,27,104,0.0,0
2,406,1,6,1,7,0.0,0
2,409,1,24,0,24,0.0,0
2,413,2,24,8,32,0.0,0
2,468,4,55,33,88,0.0,0
2,544,14,1061,0,1061,0.6005025125628141,0
2,557,4,3,40,43,0.0,0
3,120,30,1167,698,1865,0.5733788395904437,0
3,167,4,26,212,238,0.7142857142857143,0
3,686,2,4,13,17,0.0,0
3,690,1,3,0,3,0.0,0
3,751,1,101,0,101,1.0,0
3,765,1,9,3,12,1.0,0
4,126,1,3,2,5,1.0,0
4,156,2,12,5,17,1.0,0
4,225,1,25,3,28,0.8947368421052632,0
4,225,2,38,0,38,1.0,0
4,225,1,30,4,34,0.0,1
4,388,3,32,28,60,0.0,0
4,402,9,459,4,463,0.7399103139013453,0
4,407,4,42,26,68,0.0,0
4,422,3,34,11,45,0.0,0
4,443,5,0,267,267,0.0,0
4,452,1,60,38,98,0.0,0
4,453,1,11,2,13,1.0,0
4,467,22,590,20,610,1.0,0
4,498,1,7,0,7,1.0,0
4,501,10,226,6,232,1.0,0
4,514,10,165,54,219,1.0,0
4,526,1,26,6,32,1.0,0
4,528,1,4,5,9,1.0,0
4,545,2,2,6,8,0.0,0
4,592,1,10,1,11,1.0,0
4,896,56,676,393,1069,1.0,1
6,881,278,4424,3772,8196,0.11737089201877934,0
0,218,1,2,3,5,0.0,0
0,229,10,229,80,309,0.7475728155339806,0
0,435,1,49,38,87,1.0,0
0,478,3,18,10,28,0.0,0
0,478,1,3,1,4,0.0,0
0,550,3,38,2,40,0.9375,0
0,582,3,104,52,156,1.0,0
0,676,3,30,48,78,1.0,1
0,690,6,7,81,88,0.375,0
0,720,2,72,53,125,0.9545454545454546,0
0,748,1,7,1,8,1.0,0
1,236,1,135,61,196,1.0,0
1,303,7,65,80,145,0.5,0
1,375,1,10,1,11,0.0,0
1,395,2,23,9,32,0.6428571428571429,0
1,497,3,1,45,46,0.38235294117647056,0
1,509,1,25,4,29,1.0,0
1,594,2,35,5,40,0.76,0
1,715,2,537,232,769,1.0,1
1,730,2,58,36,94,1.0,0
1,793,2,26,18,44,1.0,1
2,525,19,632,217,849,1.0,1
2,672,1,120,0,120,1.0,0
2,716,2,16,0,16,1.0,0
3,248,3,21,10,31,1.0,0
3,731,3,134,0,134,1.0,0
3,929,4,341,1,342,1.0,0
4,101,1,5,8,13,1.0,0
4,184,4,41,14,55,1.0,0
4,515,15,719,398,1117,1.0,1
0,577,1,11,7,18,1.0,0
0,577,3,69,4,73,1.0,0
0,799,1,2,5,7,1.0,0
0,799,3,160,6,166,1.0,0
0,800,1,27,21,48,1.0,0
1,497,83,40,4783,4823,0.27709556860651363,0
2,477,11,212,70,282,0.978021978021978,1
2,525,1,1,3,4,1.0,0
2,573,1,79,49,128,0.0,0
2,637,2,12,1,13,0.875,0
2,637,1,9,13,22,1.0,0
2,638,1,7,6,13,0.0,0
2,639,1,16,16,32,0.0,0
2,770,1,2,2,4,0.0,0
2,776,2,422,381,803,1.0,0
3,358,1,1,1,2,1.0,0
3,362,1,11,4,15,1.0,0
3,705,19,553,255,808,1.0,1
3,776,1,13,9,22,0.0,0
3,810,3,4,2,6,0.0,1
3,846,3,61,43,104,0.0,0
3,850,1,2,4,6,1.0,0
3,894,2,8,9,17,1.0,0
4,215,1,3,4,7,1.0,0
4,313,1,7,0,7,1.0,1
4,316,2,66,10,76,0.54,0
4,641,12,320,2,322,0.9403669724770642,1
4,672,2,15,25,40,0.0,0
0,375,1,46,39,85,0.0,0
0,381,1,9,1,10,1.0,0
0,419,1,10,10,20,0.0,0
0,519,1,2,9,11,1.0,0
0,533,26,57,4540,4597,0.45633187772925765,0
0,538,3,14,4,18,1.0,0
0,545,25,4538,38,4576,0.5462440295267043,0
0,554,1,5,0,5,1.0,0
1,181,6,159,2,161,1.0,0
1,214,3,52,2,54,1.0,0
1,221,2,48,0,48,1.0,0
1,278,3,83,0,83,1.0,0
1,318,5,62,9,71,0.65,0
1,327,2,29,3,32,0.0,0
1,384,2,20,13,33,1.0,0
1,738,1,13,6,19,1.0,0
1,750,1,7,1,8,0.0,0
2,151,1,4,7,11,0.0,0
2,475,9,194,84,278,0.2823529411764706,1
2,504,3,34,5,39,1.0,0
2,567,1,2,1,3,1.0,0
2,759,3,139,2,141,1.0,0
3,212,3,246,32,278,1.0,0
3,577,1,15,2,17,1.0,0
4,121,1,28,23,51,0.0,0
4,148,2,68,2,70,1.0,0
4,199,2,44,41,85,1.0,0
4,200,1,0,5,5,0.0,0
4,206,1,5,4,9,1.0,0
4,317,2,11,5,16,0.0,0
2,515,2,58,7,65,1.0,0
2,706,1,15,1,16,0.0,0
3,106,14,233,42,275,0.47368421052631576,0
3,195,1,3,1,4,0.0,0
3,205,13,545,0,545,0.5074626865671642,0
3,458,1,3,0,3,0.0,0
3,603,2,47,11,58,0.5384615384615384,0
3,789,18,298,130,428,0.0,0
3,959,17,158,38,196,0.0,0
3,988,1,7,2,9,1.0,0
3,1006,1,7,1,8,0.0,0
3,1065,1,12,6,18,1.0,0
4,165,1,23,9,32,0.7333333333333333,0
4,433,10,317,98,415,0.24806201550387597,1
4,692,37,741,35,776,0.5136986301369864,0
4,898,10,103,86,189,0.0,0
1,173,1,85,26,111,0.3541666666666667,0
1,174,32,207,337,544,0.21875,1
1,200,6,100,36,136,0.2857142857142857,0
1,649,1,7,1,8,0.0,0
1,714,3,12,308,320,0.7023809523809523,0
1,741,31,553,176,729,0.041044776119402986,1
1,750,3,308,12,320,0.2976190476190476,1
1,761,5,39,35,74,1.0,0
1,813,3,238,22,260,0.47761194029850745,1
2,102,14,312,108,420,0.5302013422818792,0
2,219,9,176,122,298,1.0,0
2,225,1,1,7,8,1.0,0
2,354,6,150,16,166,0.41333333333333333,0
2,367,13,345,133,478,0.22142857142857142,0
2,393,1,5,8,13,0.0,0
2,424,1,12,7,19,0.0,0
2,442,2,7,6,13,0.0,0
2,504,1,2,10,12,0.0,0
2,509,1,30,24,54,0.0,0
2,512,1,2,1,3,0.0,0
2,549,2,27,8,35,1.0,0
2,573,1,8,4,12,0.0,0
2,645,1,12,4,16,1.0,0
2,702,1,5,1,6,0.0,0
2,704,1,1,0,1,0.0,0
2,723,1,15,24,39,1.0,0
2,765,1,14,11,25,0.0,0
2,874,1,15,1,16,0.0,0
2,881,1,2,1,3,1.0,0
2,896,1,25,5,30,1.0,0
2,981,20,692,0,692,1.0,0
3,673,27,96,129,225,0.2727272727272727,1
3,673,1,17,19,36,1.0,0
3,753,25,146,335,481,1.0,0
4,461,3,90,47,137,0.46875,0
4,518,3,33,0,33,1.0,0
5,542,10,124,26,150,0.0,1
6,645,1,5,0,5,1.0,0
6,704,11,375,81,456,1.0,1
0,97,1,3,1,4,0.0,0
0,136,7,19,18,37,0.0,0
0,150,1,2,0,2,1.0,0
0,152,3,2,9,11,1.0,0
0,202,1,11,0,11,1.0,0
0,240,1,5,5,10,0.0,0
0,472,1,13,51,64,0.7352941176470589,0
0,513,1,23,7,30,0.9166666666666666,0
0,530,1,2,6,8,1.0,0
0,685,6,157,34,191,0.8833333333333333,0
1,204,2,0,240,240,0.5182481751824818,0
1,357,4,93,46,139,0.0,1
1,359,1,17,11,28,1.0,0
1,577,3,22,9,31,1.0,0
2,333,5,21,11,32,0.0,0
2,398,4,59,13,72,1.0,0
2,473,7,301,0,301,1.0,0
2,492,3,36,15,51,1.0,0
2,575,1,12,5,17,1.0,0
2,690,1,11,11,22,1.0,0
2,809,1,8,2,10,1.0,0
2,898,6,241,9,250,0.13533834586466165,0
3,186,1,1,0,1,0.0,0
3,351,1,13,5,18,0.14285714285714285,1
3,406,4,37,90,127,0.0,0
3,420,2,34,52,86,0.0,0
3,481,5,168,177,345,0.0,0
3,502,2,6,5,11,0.0,0
3,526,7,163,14,177,0.0,0
3,708,17,335,109,444,0.07142857142857142,0
3,717,2,5,1,6,0.0,0
4,118,13,43,16,59,0.0,0
4,204,1,3,2,5,1.0,0
4,413,3,34,5,39,0.0,1
4,482,8,90,38,128,1.0,1
4,525,1,135,55,190,0.0,1
4,564,3,20,5,25,0.0,0
4,571,1,1,1,2,0.0,0
4,572,3,53,18,71,1.0,0
4,665,3,224,274,498,0.16363636363636364,1
4,678,1,10,6,16,0.0,0
4,694,4,92,8,100,0.47297297297297297,1
4,705,4,85,4,89,1.0,0
4,722,2,9,23,32,0.0,1
5,496,1,4,3,7,0.0,0
0,420,3,17,1,18,1.0,0
0,500,1,21,1,22,1.0,0
1,136,1,5,2,7,0.0,0
1,300,1,16,8,24,0.0,0
1,301,1,1,0,1,1.0,0
1,725,2,23,3,26,0.4666666666666667,0
3,445,2,6,3,9,0.0,0
3,521,1,3,0,3,0.0,0
1,575,7,51,17,68,1.0,0
1,826,5,10,5,15,1.0,0
2,167,2,15,1,16,0.0,1
2,266,2,8,0,8,1.0,0
2,301,1,15,9,24,0.0,0
3,210,1,6,6,12,1.0,0
3,317,2,23,19,42,0.0,0
3,481,2,67,37,104,0.0,0
3,649,2,84,58,142,0.0,0
3,670,1,6,2,8,0.0,0
3,699,1,21,3,24,0.9285714285714286,1
3,701,1,8,3,11,1.0,0
3,706,1,0,1,1,1.0,0
3,739,10,164,14,178,1.0,0
4,402,1,3,1,4,0.0,0
4,429,5,29,47,76,0.5384615384615384,0
4,555,2,16,5,21,0.75,0
4,645,3,32,4,36,1.0,0
4,661,1,53,53,106,0.0,0
4,686,2,27,23,50,0.0,0
4,690,1,8,3,11,1.0,0
4,718,3,33,13,46,0.7777777777777778,0
4,730,1,4,7,11,0.0,0
4,731,3,21,8,29,1.0,0
4,837,8,46,25,71,0.25,1
0,335,1,23,5,28,1.0,0
0,502,1,19,9,28,0.7777777777777778,0
0,722,4,93,87,180,0.0,0
0,730,1,6,0,6,1.0,0
1,220,2,7,3,10,0.0,0
1,291,2,49,0,49,1.0,0
1,307,1,7,4,11,0.0,0
1,307,1,10,0,10,1.0,0
1,502,1,87,0,87,1.0,0
1,515,3,111,0,111,1.0,0
1,530,6,120,0,120,1.0,0
1,628,1,5,0,5,1.0,0
1,644,3,36,1,37,0.6923076923076923,0
1,652,6,251,46,297,1.0,0
1,654,1,3,1,4,0.0,0
1,701,1,0,1,1,0.0,0
1,746,8,188,2,190,1.0,0
1,782,3,116,1,117,1.0,0
1,785,4,54,124,178,0.0,0
1,823,4,52,7,59,0.9,0
1,824,1,8,0,8,1.0,0
2,200,86,490,477,967,0.5968992248062015,0
3,265,1,10,4,14,0.6,0
4,658,1,16,14,30,0.0,0
4,812,2,9,6,15,0.0,0
4,835,1,8,4,12,0.75,0
3,923,2,4,12,16,1.0,0
3,1020,15,445,209,654,0.29411764705882354,1
3,1074,1,2,1,3,0.0,0
4,285,4,44,11,55,1.0,0
4,368,1,8,2,10,0.0,0
4,428,2,14,9,23,1.0,0
4,496,1,11,0,11,0.0,0
4,616,1,0,36,36,0.0,0
1,463,1,2,0,2,1.0,0
1,489,4,25,36,61,1.0,0
1,612,1,6,0,6,0.0,0
1,659,4,25,7,32,1.0,0
1,936,13,106,104,210,0.5714285714285714,1
1,938,1,7,4,11,0.0,0
1,951,1,6,2,8,1.0,0
2,156,7,25,21,46,1.0,1
2,198,1,4,3,7,0.0,0
2,340,3,138,70,208,0.0,1
2,344,1,1,0,1,0.0,0
2,356,2,11,4,15,0.0,0
2,372,2,9,0,9,0.75,0
2,434,1,3,2,5,0.0,0
3,206,1,5,4,9,0.0,0
3,388,1,3,6,9,1.0,0
4,400,1,10,5,15,1.0,0
4,479,1,9,11,20,0.0,0
2,394,4,22,2,24,1.0,0
2,508,1,20,20,40,0.0,0
2,512,1,1,1,2,0.0,0
2,541,1,6,2,8,1.0,0
3,763,4,70,2,72,1.0,0
4,217,4,142,97,239,1.0,1
4,420,3,96,0,96,1.0,0
4,442,2,57,3,60,1.0,0
4,645,2,3,2,5,0.0,0
6,589,1,2,1,3,0.0,0
0,507,1,4,1,5,1.0,1
0,511,1,2,1,3,1.0,0
0,620,4,102,20,122,0.9594594594594594,1
0,625,3,69,7,76,1.0,0
2,471,5,250,36,286,0.5688073394495413,0
4,847,4,297,55,352,1.0,0
0,742,2,121,75,196,1.0,0
1,337,4,160,34,194,0.6712328767123288,0
1,462,15,1067,7,1074,0.586,1
1,519,4,125,2,127,1.0,0
1,1257,19,790,0,790,1.0,0
2,150,26,456,470,926,0.0,1
2,180,4,47,6,53,1.0,0
2,776,2,16,1,17,1.0,0
2,1038,226,562,670,1232,0.14705882352941177,1
3,655,12,237,355,592,0.5089285714285714,1
4,441,7,233,0,233,1.0,0
4,485,3,8,2,10,1.0,1
4,854,1,1,6,7,0.0,0
4,862,1,3,0,3,1.0,0
0,732,6,408,36,444,0.9779411764705882,1
0,1062,2,8,1,9,1.0,0
0,1067,2,19,10,29,0.0,0
0,1068,7,320,0,320,1.0,0
0,1070,2,5,3,8,0.0,0
1,324,2,48,28,76,1.0,0
1,401,1,8,5,13,0.0,1
1,448,2,164,0,164,1.0,0
1,873,1,8,3,11,0.0,0
1,880,2,19,3,22,1.0,0
2,178,1,5,2,7,1.0,0
2,483,7,217,0,217,1.0,0
2,858,2,72,16,88,0.9047619047619048,0
4,262,3,44,24,68,0.8333333333333334,1
4,372,2,198,2,200,0.6036036036036037,0
4,479,1,4,1,5,0.0,0
0,350,4,138,34,172,1.0,0
0,511,1,1,1,2,0.0,0
0,559,4,26,11,37,0.23076923076923078,0
0,649,1,29,23,52,0.0,0
0,671,2,2,209,211,0.45,0
1,600,3,10,3,13,1.0,0
1,602,2,14,2,16,1.0,0
1,682,10,206,12,218,0.6481481481481481,1
1,693,1,12,0,12,1.0,0
1,722,4,130,0,130,1.0,0
2,325,15,348,22,370,0.8289473684210527,1
2,339,6,75,20,95,1.0,1
2,343,1,8,1,9,0.0,1
2,516,9,136,5,141,0.9838709677419355,1
2,899,7,431,0,431,0.618421052631579,1
2,1050,11,280,134,414,0.10948905109489052,0
2,1066,6,306,10,316,0.7913043478260869,0
3,507,8,116,13,129,0.3148148148148148,0
3,509,2,11,3,14,1.0,0
4,272,2,19,12,31,1.0,0
4,408,2,20,0,20,1.0,0
0,464,7,59,52,111,0.0,0
0,619,13,50,29,79,1.0,0
0,643,3,14,2,16,1.0,0
0,784,39,296,319,615,1.0,1
0,947,2,38,10,48,0.0,0
0,957,1,0,3,3,0.0,0
1,537,4,48,61,109,0.6666666666666666,0
1,544,157,302,211,513,0.3333333333333333,1
1,874,50,378,144,522,0.0,1
1,1031,1,0,15,15,1.0,0
1,1036,12,495,0,495,0.82,1
1,1041,4,45,12,57,0.5454545454545454,0
1,1042,12,106,18,124,1.0,0
1,1049,2,32,0,32,1.0,0
1,1073,1,30,28,58,0.0,0
1,1074,2,31,12,43,0.0,0
1,1079,1,11,5,16,0.16666666666666666,0
1,1093,1,2,4,6,1.0,0
1,1118,9,33,19,52,1.0,1
1,1119,1,1,2,3,0.0,0
1,1150,6,228,0,228,0.21428571428571427,0
1,1206,27,140,62,202,1.0,0
1,1298,2,18,6,24,1.0,1
1,1299,1,25,0,25,0.0,0
1,1307,1,0,7,7,1.0,0
2,192,3,142,0,142,0.07142857142857142,0
2,217,14,816,63,879,0.8242009132420092,1
2,242,1,27,27,54,0.0,0
2,261,1,13,11,24,0.0,1
2,263,8,405,242,647,0.8,1
2,274,2,5,40,45,0.9333333333333333,0
2,357,11,1052,24,1076,0.46261682242990654,1
2,366,1,3,2,5,1.0,0
2,410,5,184,28,212,0.776,0
2,503,1,10,1,11,1.0,0
2,516,13,45,106,151,0.0,1
2,519,2,257,0,257,0.36879432624113473,0
2,573,2,3,1,4,0.0,0
2,583,5,54,26,80,1.0,0
2,625,3,111,24,135,1.0,0
2,723,4,13,11,24,1.0,0
2,732,1,2,3,5,1.0,0
2,755,5,12,4,16,0.0,0
2,798,4,117,28,145,1.0,0
2,814,2,19,15,34,1.0,0
2,877,2,19,1,20,0.2857142857142857,0
2,880,2,5,2,7,0.0,0
2,921,3,14,19,33,1.0,0
2,1134,12,34,29,63,1.0,1
2,1163,2,151,1,152,1.0,0
3,228,13,781,998,1779,0.8888888888888888,1
3,264,2,6,8,14,1.0,0
3,275,1,6,5,11,1.0,0
3,284,5,40,12,52,1.0,1
3,294,5,49,66,115,0.0,0
3,363,2,6,27,33,0.0,0
3,398,1,35,4,39,0.0,1
3,400,1,5,4,9,0.0,1
3,451,1,37,2,39,1.0,0
3,462,2,26,7,33,1.0,0
3,489,2,9,3,12,1.0,0
3,498,1,3,1,4,0.0,0
3,533,1,2,0,2,1.0,0
3,591,5,78,44,122,1.0,0
3,708,2,2,2,4,1.0,0
3,1275,6,343,345,688,1.0,0
3,1276,1,280,122,402,0.625,0
3,1278,7,142,13,155,0.038461538461538464,0
3,1315,2,11,0,11,0.3,0
4,211,2,31,1,32,1.0,0
4,213,2,47,0,47,1.0,0
4,316,1,23,5,28,1.0,0
4,361,7,176,110,286,1.0,1
4,386,2,1,32,33,0.0,0
4,412,1,3,1,4,0.0,0
4,415,1,14,0,14,1.0,0
4,488,3,26,10,36,0.0,0
5,382,2,59,14,73,0.5357142857142857,0
5,481,3,154,127,281,0.36,1
5,1011,1,4,7,11,1.0,0
5,1023,1,92,64,156,0.0,0
5,1057,3,16,4,20,1.0,0
5,1102,1,104,59,163,1.0,1
5,1112,1,3,1,4,0.0,0
5,1122,2,10,5,15,0.0,0
5,1139,1,27,11,38,0.3076923076923077,0
5,1142,1,12,6,18,0.0,0
5,1145,1,6,1,7,0.0,0
5,1189,1,10,1,11,0.0,0
6,433,1,2,8,10,1.0,0
6,437,1,3,22,25,1.0,0
0,188,1,13,1,14,0.0,0
0,366,9,319,49,368,1.0,0
0,379,2,12,3,15,1.0,0
0,432,2,16,0,16,1.0,0
0,438,3,86,1,87,1.0,1
0,459,1,9,1,10,1.0,0
0,463,1,9,1,10,1.0,0
0,472,1,3,0,3,1.0,0
0,475,1,25,0,25,1.0,0
0,605,1,118,0,118,1.0,0
2,236,1,8,1,9,1.0,1
2,427,1,29,3,32,1.0,0
2,439,16,430,186,616,1.0,0
3,734,1,21,2,23,0.0,0
0,732,1,7,2,9,1.0,0
1,194,1,10,3,13,0.8333333333333334,0
1,212,1,3,11,14,0.16666666666666666,0
1,213,1,11,3,14,0.8333333333333334,0
1,223,1,2,0,2,0.0,0
1,666,1,12,4,16,1.0,1
1,823,5,70,43,113,1.0,0
1,830,1,20,1,21,0.0,0
1,869,1,66,24,90,0.0,0
1,885,3,25,5,30,1.0,0
1,885,1,2,2,4,1.0,0
2,421,1,169,87,256,0.0,0
2,573,1,132,107,239,1.0,0
2,656,1,26,2,28,0.13636363636363635,0
2,676,2,83,26,109,0.5952380952380952,0
2,711,10,170,48,218,0.4166666666666667,0
2,729,3,31,1,32,0.0,1
3,201,7,191,69,260,0.9104477611940298,1
3,243,1,14,2,16,0.0,0
3,388,3,24,16,40,0.8,1
3,496,1,22,11,33,0.0,0
3,961,8,33,19,52,0.0,0
3,962,21,1574,85,1659,0.4091403699673558,1
4,360,4,34,9,43,0.0,1
4,448,1,30,5,35,1.0,0
5,276,3,43,0,43,0.0,0
5,276,5,202,17,219,0.76,0
5,366,2,75,64,139,0.25,1
5,395,9,286,5,291,1.0,0
5,426,5,1,118,119,0.0,0
5,450,1,2,1,3,1.0,0
5,460,5,167,11,178,1.0,0
5,775,1,93,0,93,0.13157894736842105,1
5,782,5,38,2,40,0.4,1
5,835,1,4,2,6,1.0,0
0,718,2,103,14,117,1.0,0
0,783,1,13,11,24,1.0,0
2,574,39,1566,402,1968,0.5296551724137931,1
3,285,1,1,2,3,1.0,1
3,287,4,17,28,45,0.2,0
3,385,1,2,2,4,0.0,0
3,741,2,1,136,137,0.012345679012345678,0
3,860,3,17,43,60,1.0,0
3,871,3,11,7,18,0.25,0
4,440,1,6,1,7,1.0,0
4,692,10,55,43,98,0.0,0
5,361,2,280,224,504,1.0,0
5,367,14,214,189,403,0.0,1
5,586,3,18,11,29,0.0,0
6,192,1,114,63,177,1.0,0
6,202,1,16,1,17,1.0,0
6,761,1,27,20,47,1.0,0
2,1208,3,37,3,40,1.0,0
3,166,2,10,4,14,0.0,0
4,376,2,6,0,6,0.0,0
4,503,1,28,13,41,0.0,0
4,911,1,2,1,3,1.0,0
1,335,1,15,14,29,0.0,0
1,336,1,103,1,104,1.0,0
1,540,2,19,1,20,0.0,0
1,694,1,6,6,12,1.0,0
2,178,3,259,216,475,0.6764705882352942,1
2,204,1,5,0,5,1.0,0
2,328,1,9,9,18,1.0,0
2,954,5,55,25,80,0.0,0
2,1012,2,2,4,6,0.0,0
4,585,6,59,21,80,0.9411764705882353,0
4,743,1,4,4,8,1.0,0
4,785,3,35,2,37,0.2222222222222222,0
4,791,1,16,35,51,1.0,0
4,793,1,5,2,7,0.0,0
1,361,3,86,82,168,0.8333333333333334,0
1,389,1,1,0,1,1.0,0
1,523,1,47,45,92,0.0,1
1,562,2,37,20,57,0.0,0
1,574,3,27,6,33,1.0,0
2,507,2,24,1,25,1.0,0
2,561,4,115,5,120,0.45569620253164556,0
3,143,1,12,5,17,0.0,0
3,402,8,66,38,104,1.0,1
3,403,4,284,0,284,1.0,1
3,406,3,23,0,23,1.0,0
3,413,1,19,14,33,1.0,0
3,434,1,3,2,5,0.0,0
3,444,1,3,3,6,0.0,0
3,467,2,1,24,25,0.0,0
3,477,1,5,2,7,1.0,0
3,478,2,24,1,25,1.0,0
3,516,2,17,17,34,1.0,0
4,90,2,50,25,75,1.0,1
4,170,1,16,20,36,0.4,0
0,446,1,0,6,6,1.0,0
0,597,5,135,3,138,0.9344262295081968,0
0,734,1,18,19,37,1.0,0
1,150,11,244,1427,1671,0.6104972375690608,1
1,352,4,4,96,100,0.5797101449275363,1
2,168,3,22,25,47,1.0,0
2,185,2,12,13,25,1.0,0
2,428,1,10,9,19,1.0,0
3,339,2,10,1,11,0.0,0
3,460,1,31,0,31,0.0,0
3,694,1,1,5,6,0.0,0
4,113,1,13,4,17,0.0,0
5,138,4,46,4,50,1.0,0
5,207,2,82,2,84,1.0,0
5,465,1,5,3,8,0.0,0
3,130,1,90,0,90,1.0,0
3,134,4,296,0,296,1.0,0
3,233,2,19,15,34,1.0,0
3,334,1,6,14,20,0.0,0
3,398,3,44,13,57,1.0,0
3,400,1,20,1,21,1.0,0
3,424,3,8,6,14,1.0,0
3,499,1,7,0,7,0.0,0
3,515,1,4,0,4,0.0,0
3,535,19,358,59,417,0.7090909090909091,1
4,339,1,101,76,177,0.0,0
4,388,9,288,0,288,1.0,0
4,482,2,10,2,12,1.0,0
4,579,17,250,223,473,0.0,1
4,588,31,2316,0,2316,0.3709561466570812,0
0,167,2,28,34,62,0.0,0
0,172,4,25,31,56,0.0,0
0,292,2,66,24,90,0.0,0
0,422,5,124,9,133,0.34615384615384615,0
0,463,4,112,29,141,0.3076923076923077,0
0,471,3,23,14,37,0.75,0
0,479,1,5,13,18,0.0,0
0,552,49,423,148,571,0.0,0
0,807,6,217,0,217,1.0,0
0,810,1,1,0,1,1.0,0
0,993,18,881,12,893,0.3431952662721893,0
1,105,2,9,9,18,1.0,0
1,126,3,14,18,32,1.0,0
1,131,2,24,0,24,0.047619047619047616,0
1,135,2,17,3,20,0.07692307692307693,0
1,142,1,82,0,82,1.0,0
1,213,1,11,9,20,0.0,0
1,308,2,6,4,10,1.0,0
1,348,1,0,19,19,0.0,0
1,545,4,84,273,357,1.0,0
1,577,3,256,148,404,0.9154929577464789,1
1,663,4,66,13,79,0.6170212765957447,1
1,670,1,2,3,5,0.0,0
2,134,1,2,2,4,1.0,0
2,414,1,4,5,9,1.0,1
2,437,1,2,11,13,0.0,1
2,497,4,139,5,144,0.9361702127659575,0
3,486,1,90,92,182,1.0,0
3,494,1,6,4,10,0.0,0
3,527,3,35,2,37,0.96,0
3,879,5,22,14,36,0.0,0
3,894,1,14,3,17,0.0,1
3,913,1,83,7,90,1.0,0
3,920,1,14,38,52,0.0,0
4,125,2,5,1,6,0.0,0
4,184,8,15,11,26,1.0,0
4,408,6,99,5,104,0.7704918032786885,0
0,173,2,21,19,40,0.0,0
0,206,3,12,6,18,1.0,0
0,214,1,2,0,2,1.0,0
0,345,2,16,1,17,0.0,0
0,393,1,3,2,5,0.0,0
0,469,3,34,40,74,1.0,0
1,722,1,3,0,3,0.0,0
1,737,1,7,5,12,0.0,0
2,172,1,15,3,18,0.0,0
3,104,1,57,0,57,1.0,0
3,400,3,38,13,51,0.48,0
4,158,3,4,3,7,0.0,0
4,166,4,132,209,341,1.0,0
4,209,11,68,891,959,0.5681818181818182,0
4,358,4,116,4,120,0.1016949152542373,0
4,365,1,11,1,12,0.0,0
4,396,4,92,6,98,1.0,0
4,463,3,143,2,145,0.7714285714285715,0
4,492,1,143,0,143,0.06818181818181818,0
4,500,1,4,0,4,1.0,0
4,506,38,13617,0,13617,0.8593000117054899,0
4,643,2,8,4,12,0.0,0
4,651,2,11,13,24,1.0,0
4,707,1,15,3,18,0.42857142857142855,0
4,707,2,76,0,76,1.0,0
4,707,2,77,0,77,1.0,0
0,793,1,25,9,34,1.0,0
1,167,1,11,6,17,1.0,0
1,450,2,49,1,50,0.9310344827586207,0
1,455,5,186,253,439,0.3181818181818182,0
1,469,1,2,1,3,0.0,0
1,501,8,285,0,285,1.0,0
1,501,5,146,6,152,0.0,0
1,635,1,6,4,10,0.0,0
1,665,1,8,3,11,1.0,0
2,202,3,40,31,71,0.0,0
3,438,114,1380,15571,16951,0.14067954386781475,0
0,679,114,15572,1381,16953,0.8593204561321852,1
1,612,4,29,49,78,0.5714285714285714,0
1,636,6,252,17,269,1.0,1
1,771,1,6,1,7,0.0,0
2,136,3,67,16,83,1.0,1
2,228,1,18,5,23,0.0,1
2,274,1,3,0,3,0.0,0
2,619,3,62,26,88,1.0,0
2,656,1,18,0,18,1.0,0
3,185,3,2,49,51,0.0,0
0,493,15,456,53,509,0.18705035971223022,0
0,529,88,1162,1080,2242,0.0,0
0,676,1,2,0,2,1.0,0
0,691,1,7,0,7,1.0,0
1,289,64,3,0,3,0.0,1
1,325,1,12,5,17,1.0,0
3,313,1,3,9,12,1.0,0
3,319,1,44,1,45,1.0,0
3,353,3,82,13,95,1.0,0
1,432,1,18,6,24,0.0,0
1,433,1,67,58,125,0.0,0
1,440,19,548,72,620,0.8095238095238095,1
1,521,7,202,374,576,1.0,0
2,195,2,36,4,40,0.7,0
2,400,1,22,0,22,1.0,0
2,442,1,8,8,16,0.0,0
2,565,7,112,39,151,1.0,1
2,703,1,19,2,21,1.0,0
2,729,5,18,14,32,0.0,0
3,435,1,15,9,24,1.0,0
3,441,1,2,0,2,0.0,0
3,555,1,5,1,6,1.0,0
4,181,2,52,17,69,0.0,1
2,375,3,234,183,417,0.9487179487179487,0
3,91,6,188,191,379,1.0,0
3,193,3,124,2,126,0.36363636363636365,1
3,460,1,1,0,1,0.0,0
3,574,2,9,24,33,0.0,0
3,592,3,60,18,78,1.0,0
0,212,1,4,0,4,0.0,0
0,212,1,4,1,5,1.0,0
1,183,1,443,441,884,0.0,0
1,198,2,62,0,62,1.0,0
1,291,3,347,309,656,1.0,1
3,159,1,7,4,11,0.0,0
4,288,1,9,7,16,0.0,0
4,326,1,34,0,34,1.0,0
4,340,1,5,1,6,1.0,0
4,522,4,122,1,123,0.9298245614035088,0
4,527,2,3,1,4,0.0,0
4,641,8,114,75,189,0.0,0
4,736,5,14,0,14,0.6666666666666666,0
5,768,3,174,0,174,1.0,0
5,769,9,233,147,380,1.0,0
5,832,1,12,3,15,1.0,0
6,588,10,611,170,781,0.5860215053763441,1
0,199,1,18,0,18,1.0,0
2,293,4,663,609,1272,1.0,0
2,305,2,55,32,87,1.0,1
2,581,3,116,51,167,1.0,0
2,636,4,595,574,1169,0.2857142857142857,0
2,736,3,157,0,157,1.0,0
2,800,4,24,4,28,0.9285714285714286,1
3,991,6,51,2,53,1.0,0
3,129,3,19,5,24,0.5,1
3,153,1,6,0,6,0.0,0
3,164,2,38,8,46,1.0,1
3,275,6,39,18,57,1.0,0
3,279,5,10,31,41,0.8947368421052632,0
3,309,2,25,12,37,0.45454545454545453,0
3,327,4,6,5,11,1.0,0
3,365,10,456,57,513,0.6337209302325582,0
3,674,1,1,7,8,0.0,0
3,686,1,6,4,10,0.0,0
3,687,3,88,3,91,1.0,1
4,967,1,22,0,22,1.0,0
4,95,6,110,49,159,1.0,1
4,391,2,37,43,80,1.0,0
4,477,3,27,1,28,0.0,1
4,526,1,89,82,171,0.0,0
0,117,2,85,3,88,0.9830508474576272,0
0,202,2,18,10,28,0.4444444444444444,0
0,417,12,225,129,354,1.0,0
0,420,5,102,3,105,1.0,0
1,407,1,16,31,47,1.0,0
1,447,1,149,0,149,1.0,1
1,655,8,281,85,366,0.6842105263157895,1
1,887,3,222,4,226,1.0,0
1,903,1,19,1,20,1.0,0
2,202,3,17,18,35,0.0,0
2,209,2,5,5,10,0.0,0
2,209,1,46,0,46,1.0,0
2,336,2,15,0,15,1.0,0
2,348,3,31,14,45,0.0,0
3,333,2,2,1,3,1.0,0
3,766,1,58,22,80,0.0,1
3,812,350,27949,21,27970,0.6205293615406507,1
4,106,1,3,1,4,0.0,0
4,115,1,21,0,21,1.0,0
0,110,49,2034,688,2722,0.10762331838565023,0
0,438,20,196,286,482,0.0,1
0,672,1,6,0,6,1.0,0
0,742,1,3,2,5,1.0,0
0,755,4,77,57,134,0.76,0
0,782,4,9,271,280,0.0,0
0,795,2,14,5,19,0.8571428571428571,0
0,802,1,3,0,3,0.0,0
0,803,1,11,9,20,0.0,0
1,1007,18,225,47,272,0.3560606060606061,0
1,90,2,74,66,140,0.0,0
1,213,1,4,6,10,0.0,0
1,218,3,22,76,98,0.0,1
1,685,1,0,68,68,0.0,0
1,690,3,84,8,92,0.875,0
1,724,5,235,29,264,0.26973684210526316,0
1,953,17,205,114,319,0.0,0
2,1006,4,58,2,60,1.0,0
2,1075,13,57,61,118,1.0,0
2,1078,9,0,510,510,0.0,0
2,1138,1,27,5,32,0.0,0
2,223,1,3,1,4,1.0,0
2,236,1,6,4,10,0.0,0
2,301,1,20,16,36,0.0,0
2,378,1,15,14,29,0.0,0
2,411,1,12,13,25,1.0,1
2,420,2,81,7,88,0.3508771929824561,1
2,431,2,26,2,28,0.0,1
2,547,1,3,0,3,0.0,0
2,799,1,9,1,10,1.0,0
2,944,5,35,25,60,0.42857142857142855,1
3,167,2,66,47,113,0.0,0
3,177,1,8,0,8,1.0,0
3,856,2,26,13,39,1.0,1
4,461,4,57,50,107,1.0,0
4,467,1,18,18,36,1.0,0
4,492,1,204,204,408,0.0,0
1,172,1,23,4,27,0.0,0
2,352,6,317,147,464,1.0,0
2,362,7,97,26,123,0.9649122807017544,0
3,344,5,8,11,19,0.0,0
3,416,2,11,3,14,0.0,1
3,692,1,13,2,15,0.0,0
4,257,1,3,0,3,1.0,0
4,587,1,32,29,61,0.0,1
5,216,2,17,2,19,1.0,0
0,453,3,102,10,112,1.0,1
0,717,1,4,2,6,1.0,0
0,732,18,85,152,237,0.022222222222222223,0
0,859,1,3,0,3,1.0,1
0,860,39,913,786,1699,0.0,0
0,876,5,164,0,164,1.0,0
1,190,1,1,5,6,0.75,0
1,433,11,103,108,211,1.0,0
1,435,5,35,28,63,0.875,1
1,436,8,34,35,69,0.0,0
1,570,2,42,45,87,1.0,0
2,314,3,36,6,42,1.0,1
2,512,2,12,7,19,0.0,1
2,681,1,130,120,250,1.0,0
2,770,1,10,0,10,0.5,0
2,792,1,17,0,17,0.0,0
2,793,3,55,11,66,0.375,0
3,175,1,4,17,21,1.0,0
3,216,4,16,53,69,0.0,1
3,362,4,138,11,149,1.0,1
4,131,1,52,7,59,1.0,0
4,365,1,6,2,8,0.0,0
4,427,3,9,0,9,0.3333333333333333,0
4,646,2,6,8,14,1.0,0
1,458,1,34,0,34,1.0,0
1,620,2,57,7,64,0.7435897435897436,0
1,687,2,7,5,12,0.0,0
0,200,1,12,3,15,0.375,0
1,168,1,214,213,427,0.0,0
1,170,1,7,2,9,0.0,0
1,230,2,186,174,360,1.0,0
1,579,1,21,5,26,0.0,0
1,771,5,212,67,279,1.0,0
2,656,13,53,25,78,1.0,1
3,224,2,95,1,96,0.851063829787234,0
3,369,1,2,1,3,1.0,0
0,174,1,39,0,39,1.0,0
1,283,2,25,5,30,1.0,1
2,194,6,244,81,325,0.825,0
3,962,1,22,15,37,0.0,0
0,185,1,4,2,6,0.0,0
3,407,1,7,3,10,0.0,0
3,475,2,32,12,44,1.0,0
3,494,2,25,0,25,0.9545454545454546,0
3,494,2,25,0,25,0.9545454545454546,0
3,561,1,1,0,1,1.0,0
4,124,2,14,1,15,1.0,1
4,133,2,12,31,43,0.0,0
4,205,2,25,2,27,1.0,0
4,212,1,10,8,18,1.0,0
2,398,1,10,1,11,0.0,0
2,436,15,433,61,494,0.14705882352941177,1
2,522,6,86,1,87,1.0,0
3,589,1,83,81,164,1.0,0
2,633,1,179,0,179,1.0,0
3,491,3,89,8,97,1.0,0
0,187,3,183,74,257,1.0,0
0,339,34,3547,718,4265,0.9655172413793104,1
0,625,9,1077,2,1079,0.9341935483870968,0
3,201,20,1214,430,1644,0.39436619718309857,1
4,381,1,66,0,66,1.0,0
1,635,5,1005,0,1005,0.45779685264663805,1
2,168,3,55,24,79,1.0,0
2,362,2,163,0,163,1.0,0
2,520,6,197,14,211,0.6912751677852349,0
6,396,2,7,1,8,0.6666666666666666,0
1,326,2,24,0,24,1.0,1
1,356,3,49,5,54,0.9375,0
2,132,3,64,1,65,1.0,0
2,167,2,14,1,15,0.0,0
4,428,4,109,2,111,1.0,0
4,462,1,3,1,4,0.0,0
1,582,1,2,0,2,0.0,0
6,583,1,57,44,101,1.0,0
2,193,1,6,2,8,1.0,1
5,206,1,48,46,94,0.0,0
3,478,1,0,6,6,1.0,0
2,974,81,20666,57,20723,0.5350850077279753,1
5,492,4,89,59,148,0.8571428571428571,1
1,520,2,28,36,64,0.0,0
1,537,1,3,0,3,1.0,0
6,432,2,24,22,46,1.0,0
6,441,1,6,0,6,1.0,0
6,471,2,17,17,34,0.0,0
2,549,3,71,74,145,1.0,0
3,168,4,58,3,61,1.0,1
3,605,1404,78332,78157,156489,0.0,1
1,470,2,5,1,6,1.0,0
2,384,1,5,2,7,0.0,1
2,413,2,203,21,224,0.6168831168831169,0
2,698,9,66,20,86,1.0,1
3,236,1,5,5,10,1.0,0
3,578,2,24,1,25,0.0,0
1,187,20,673,625,1298,0.8333333333333334,0
1,530,18,106,1,107,0.9836065573770492,0
1,649,3,67,24,91,0.5185185185185185,1
1,651,2,45,1,46,0.0,1
2,186,1,2,8,10,0.0,0
2,197,1,3,9,12,0.0,0
3,235,2,3,2,5,1.0,0
1,387,11,2,363,365,0.0,0
1,702,1,59,64,123,0.8571428571428571,0
1,704,1,8,11,19,1.0,1
1,705,3,13,16,29,0.0,0
1,707,1,9,13,22,0.0,1
2,118,2,2,4,6,0.0,0
3,777,5,244,164,408,0.10204081632653061,1
3,785,3,7,23,30,1.0,0
1,209,3,37,13,50,0.2,0
1,234,1,54,49,103,1.0,1
1,661,1,17,11,28,0.0,0
2,87,1,73,1,74,1.0,0
2,331,1,60,26,86,1.0,0
2,420,1,11,4,15,1.0,1
2,503,2,5,1,6,0.0,0
3,385,1,16,4,20,1.0,1
4,135,4,210,1,211,0.17355371900826447,1
4,353,2,17,7,24,1.0,0
4,359,2,17,4,21,0.46153846153846156,0
4,762,18,899,1,900,0.9959432048681541,1
1,229,2,18,18,36,1.0,1
1,446,3,5,1,6,0.0,1
2,110,16,2071,2,2073,0.7939068100358423,1
6,641,1,4,0,4,0.0,0
0,226,1,3,2,5,0.0,0
0,908,9,56,36,92,0.0,1
1,237,2,65,1,66,1.0,0
1,563,5,142,0,142,0.9705882352941176,0
1,658,2,63,1,64,0.08571428571428572,0
2,377,1,4,5,9,0.0,0
4,157,2,2,1,3,0.0,0
5,579,5,71,23,94,1.0,0
5,607,7,473,25,498,0.9761904761904762,1
6,792,8,85,47,132,0.6,1
0,379,6,114,16,130,0.23684210526315788,0
1,734,8,155,10,165,1.0,1
1,741,12,213,65,278,0.4931506849315068,0
3,503,1,12,1,13,0.0,0
4,883,79,1730,60,1790,0.8080985915492958,1
5,408,1,151,141,292,1.0,0
3,127,3,6,30,36,0.0,0
3,424,91,3447,115,3562,0.9196428571428571,1
3,673,1,10,1,11,1.0,0
3,702,1,6,9,15,1.0,0
3,756,2,2,0,2,1.0,1
1,225,49,2905,10,2915,0.8056801195814649,1
1,466,2,5,1,6,1.0,0
2,226,10,22,222,244,1.0,0
2,775,4,31,9,40,0.9444444444444444,1
4,737,2,18,3,21,0.25,1
0,313,9,65,22,87,0.0,0
1,599,40,3802,374,4176,0.9024390243902439,1
1,734,6,47,66,113,1.0,1
3,499,1,0,53,53,0.0,0
0,365,50,776,925,1701,0.0,1
1,513,63,3066,22,3088,0.7908309455587392,1
2,486,17,159,148,307,0.0,0
2,537,2,13,52,65,0.6176470588235294,0
2,585,17,183,89,272,0.7692307692307693,1
3,68,39,377,341,718,1.0,0
3,69,3,0,154,154,0.0,0
3,337,22,1002,0,1002,1.0,0
3,207,3,123,45,168,1.0,0
3,461,399,1253,35053,36306,0.4606008850244546,0
3,576,22,0,1542,1542,0.693717277486911,0
0,196,2,0,79,79,0.0,0
3,207,3,123,45,168,1.0,0
2,496,2,11,1,12,0.7,0
2,530,2,11,4,15,0.0,0
2,455,3,16,2,18,1.0,0
3,361,8,188,41,229,0.9782608695652174,0
3,437,17,205,54,259,1.0,1
4,521,2,76,10,86,1.0,0
4,525,2,5,5,10,1.0,0
4,527,4,17,18,35,0.3333333333333333,1
6,35,7,0,1126,1126,0.7119078104993598,0
0,119,18,303,59,362,1.0,1
1,393,1,11,5,16,0.0,1
1,448,5,36,49,85,0.0,0
2,193,2,26,38,64,0.0,0
2,597,4,82,28,110,1.0,0
3,430,1,4,2,6,1.0,0
0,439,1,4,1,5,1.0,0
0,440,2,0,35,35,0.6,0
2,650,4,94,0,94,1.0,0
3,800,11,619,69,688,0.9093959731543624,0
4,440,1,6,13,19,0.0,0
0,191,1,8,2,10,0.0,0
1,334,2,17,3,20,0.0,0
5,352,1,2,7,9,1.0,0
5,412,6,46,5,51,1.0,0
5,417,1,14,13,27,0.0,0
5,437,1,8,3,11,0.0,0
5,539,10,38,52,90,1.0,0
0,592,3,14,29,43,0.0,0
1,334,2,10,10,20,1.0,0
3,418,3,51,57,108,1.0,1
0,154,4,59,22,81,0.7,0
1,724,295,16320,7767,24087,0.9466694334924258,0
4,486,4,30,0,30,1.0,0
1,210,2,10,10,20,1.0,0
2,181,3,47,39,86,0.0,0
3,231,9,178,99,277,1.0,0
6,143,15,57,125,182,0.6206896551724138,1
0,693,2,1,6,7,0.0,0
0,895,6,314,0,314,0.8225806451612904,1
1,157,4,24,2,26,0.6666666666666666,0
1,227,3,27,14,41,0.0,0
5,370,7,255,135,390,1.0,0
5,380,473,2382,253,2635,0.73125,1
5,387,1,1,3,4,0.0,0
5,426,1,126,113,239,1.0,1
0,208,15,241,36,277,0.0,0
0,259,28,1258,121,1379,0.9701492537313433,1
1,141,1,27,4,31,1.0,0
1,360,4,53,18,71,1.0,0
1,446,2,6,0,6,0.0,0
1,451,1,2,32,34,0.0,0
3,410,27,814,671,1485,0.015037593984962405,0
3,651,1,90,73,163,1.0,0
0,601,1,22,34,56,0.0,0
3,345,19,1193,8,1201,0.998422712933754,0
3,352,59,715,5428,6143,0.2004864489228631,0
3,427,3,0,273,273,0.0,0
3,503,7,213,17,230,1.0,0
3,506,16,1093,70,1163,1.0,0
4,332,8,544,2,546,1.0,0
2,410,3,21,11,32,0.0,0
2,417,1,1,2,3,1.0,0
2,435,1,3,3,6,1.0,0
2,593,25,1534,2,1536,1.0,0
2,650,1,1,0,1,1.0,0
3,587,3,318,12,330,0.9153439153439153,0
3,845,1,174,0,174,1.0,0
5,764,1,41,42,83,1.0,0
5,768,1,1,6,7,1.0,0
0,169,4,221,2,223,1.0,0
0,366,2,30,0,30,0.9166666666666666,0
0,468,5,277,5,282,1.0,0
0,472,7,324,0,324,1.0,0
0,475,52,192,334,526,0.0,0
0,485,6,15,21,36,1.0,0
1,119,6,207,2,209,1.0,0
1,128,11,678,15,693,1.0,1
1,333,1,17,2,19,1.0,0
1,440,6,416,5,421,1.0,0
1,582,3,92,1,93,1.0,0
2,130,7,445,61,506,1.0,0
3,231,1,8,1,9,1.0,0
5,102,1,5,0,5,1.0,0
5,192,1,0,9,9,0.0,0
0,476,14,321,42,363,0.9861111111111112,0
2,556,5,17,31,48,0.0,1
3,496,1,0,10,10,0.0,0
3,501,2,16,1,17,1.0,0
3,572,1,13,12,25,0.0,0
1,445,2,34,1,35,1.0,0
2,130,1,4,2,6,0.0,1
3,404,1,3,1,4,1.0,0
4,131,1,9,1,10,1.0,0
4,148,1,6,4,10,1.0,0
0,406,7,291,2,293,1.0,0
2,130,5,350,0,350,1.0,0
3,143,8,393,0,393,1.0,0
3,487,9,197,51,248,1.0,1
3,491,3,154,0,154,0.5932203389830508,0
3,501,38,353,169,522,0.5098039215686274,1
4,269,9,446,0,446,1.0,0
4,307,14,606,6,612,1.0,0
4,422,24,763,21,784,0.7687861271676301,1
4,452,2,5,3,8,1.0,1
4,530,1,28,72,100,0.0,0
4,558,4,61,1,62,0.8,0
4,733,1,8,14,22,0.0,1
2,162,3,262,0,262,1.0,0
2,503,6,379,25,404,1.0,1
2,507,6,230,23,253,1.0,0
3,131,120,6,23756,23762,0.48861264857998365,0
3,560,2,301,37,338,1.0,0
3,666,46,829,386,1215,1.0,0
4,192,2,14,2,16,1.0,1
4,221,3,115,18,133,1.0,0
4,548,2,220,3,223,1.0,0
0,131,1,20,0,20,1.0,0
0,195,1,0,1,1,1.0,0
0,350,1,4,5,9,1.0,0
0,359,2,4,1,5,1.0,0
0,577,1,22,5,27,1.0,1
0,577,1,6,1,7,1.0,0
1,456,10,371,30,401,0.5094339622641509,0
1,530,1,2,1,3,0.0,0
2,393,4,144,12,156,1.0,0
3,66,32,533,93,626,0.56,1
3,134,8,512,10,522,1.0,1
4,370,1624,6621,12153,18774,0.32408102025506375,1
1,182,10,595,69,664,1.0,0
1,211,169,5984,464,6448,0.9177514792899408,1
1,353,5,174,0,174,1.0,0
1,366,2,24,6,30,0.0,0
3,809,5,164,0,164,1.0,0
0,391,7,173,1,174,1.0,0
0,713,3,74,3,77,1.0,0
2,175,1,70,0,70,1.0,0
3,498,3,147,0,147,1.0,0
4,376,2,6,16,22,0.0,0
0,123,19,1030,1,1031,1.0,0
4,1009,3,32,21,53,1.0,0
4,746,19,1661,0,1661,0.8605947955390335,0
0,376,1,1,2,3,0.0,0
0,377,3,35,2,37,1.0,0
0,872,21,47,38,85,1.0,0
2,114,32,732,298,1030,0.8306010928961749,1
3,354,2,15,3,18,0.5714285714285714,0
2,162,115,1438,563,2001,0.9528795811518325,0
2,755,2,35,12,47,1.0,0
2,792,3,23,0,23,1.0,0
0,770,1,31,6,37,1.0,1
2,152,4,116,0,116,1.0,0
3,104,9,193,42,235,1.0,0
3,581,2,24,0,24,0.4444444444444444,0
3,741,1,11,2,13,1.0,1
1,313,6,113,47,160,0.9090909090909091,1
1,319,3,119,13,132,1.0,0
1,507,26,1519,88,1607,0.8367346938775511,1
2,110,6,37,3,40,0.6666666666666666,0
2,147,2,47,0,47,0.9736842105263158,0
3,368,13,239,35,274,0.3114754098360656,1
3,467,1,9,0,9,0.0,0
3,601,10,187,85,272,0.7868852459016393,1
0,161,42,1555,29,1584,1.0,0
1,151,2,14,3,17,1.0,1
1,589,1,198,0,198,1.0,0
3,180,6,48,37,85,0.0,0
3,193,2,6,2,8,0.5,0
3,208,2,41,5,46,0.8571428571428571,1
3,413,12,329,80,409,0.8028169014084507,1
3,598,1,5,3,8,0.0,0
0,168,7,56,25,81,1.0,1
0,464,5,73,326,399,0.0,1
2,144,1,264,27,291,1.0,0
2,159,1,86,1,87,1.0,0
2,187,1,222,224,446,1.0,0
3,535,6,381,364,745,1.0,0
3,588,1,9,3,12,0.0,0
4,122,2,40,20,60,1.0,0
4,192,4,60,1,61,0.825,1
4,463,8,273,5,278,0.6793893129770993,1
4,467,2,13,6,19,0.6,0
1,79,25,659,247,906,0.24867724867724866,1
1,326,10,1202,38,1240,0.67578125,1
2,497,13,360,18,378,0.7843137254901961,0
3,368,11,69,24,93,1.0,1
6,337,29,936,101,1037,0.9789156626506024,1
6,597,10,70,19,89,0.8181818181818182,1
0,276,1,8,11,19,0.0,0
1,564,14,230,69,299,0.6153846153846154,0
1,565,3,16,0,16,1.0,0
4,604,2,19,0,19,1.0,0
4,730,2,288,0,288,1.0,0
6,918,1,34,32,66,0.0,0
0,308,12,110,355,465,0.13761467889908258,0
0,532,8,31,33,64,0.0,1
1,404,9,135,56,191,0.8333333333333334,1
1,404,15,123,64,187,1.0,0
1,411,2,17,8,25,0.0,0
1,631,30,1746,9,1755,0.6630434782608695,1
3,682,2,40,13,53,0.8,0
4,494,10,224,275,499,1.0,0
4,496,30,902,265,1167,0.8184713375796179,1
4,497,4,11,1,12,1.0,0
4,513,2,0,108,108,0.0,0
6,544,5,85,54,139,1.0,1
6,548,1,3,0,3,0.0,0
0,395,1,13,2,15,1.0,0
1,295,1,1,0,1,0.0,0
1,416,5,69,44,113,0.7894736842105263,0
1,452,2,14,2,16,0.6363636363636364,0
1,497,1,30,7,37,0.0,0
1,566,3,7,5,12,0.0,0
1,567,4,25,24,49,0.0,0
4,63,3,50,2,52,0.7272727272727273,0
4,376,7,29,14,43,0.0,1
4,407,2,24,3,27,1.0,0
4,487,5,136,80,216,1.0,0
4,571,40,1639,65,1704,0.6727272727272727,1
1,141,1,14,16,30,1.0,0
1,633,32,756,25,781,0.7572254335260116,0
2,64,2,16,5,21,1.0,0
2,198,2,28,2,30,1.0,0
2,283,1,13,1,14,0.0,1
2,568,1,18,0,18,1.0,0
2,679,8,362,12,374,1.0,1
3,579,2,40,0,40,1.0,0
4,57,21,180,90,270,0.2111111111111111,0
4,155,2,25,5,30,0.6,0
4,599,6,46,13,59,0.42857142857142855,0
1,586,3,15,16,31,0.0,0
2,548,1,101,43,144,0.17307692307692307,0
4,970,5,156,13,169,1.0,1
4,619,11,501,13,514,1.0,0
5,429,5,130,6,136,1.0,0
5,447,1,12,0,12,1.0,0
1,229,2,0,108,108,0.0,0
1,517,3,24,23,47,0.0,0
1,554,5,314,11,325,1.0,0
1,645,5,0,74,74,0.0,0
2,348,1,5,0,5,0.0,0
3,235,1,23,42,65,0.0,0
4,220,13,37,64,101,0.0,0
0,82,52,2076,60,2136,0.9191321499013807,1
0,815,82,446,6427,6873,0.21296296296296297,0
1,496,4,80,7,87,1.0,0
2,134,2,180,11,191,0.8058252427184466,0
2,365,27,428,259,687,0.8837209302325582,0
2,367,6,64,20,84,1.0,0
2,474,5,44,18,62,1.0,1
2,528,4,36,40,76,0.0,0
2,579,35,70,1074,1144,0.19161676646706588,0
2,582,23,1151,0,1151,0.8083832335329342,1
4,199,3,46,18,64,1.0,0
4,385,13,148,81,229,0.0,1
6,331,4,26,36,62,0.0,1
1,215,2,119,41,160,1.0,0
1,275,64,1571,939,2510,0.4015873015873016,1
1,399,3,71,56,127,0.0,0
2,102,2,13,1,14,1.0,0
2,161,1,3,3,6,1.0,0
2,183,5,18,10,28,0.0,0
2,412,10,71,150,221,0.0,0
3,757,38,1828,148,1976,0.8828382838283828,0
4,186,11,547,0,547,1.0,1
4,327,5,331,93,424,0.6411764705882353,1
4,385,11,266,242,508,0.0,0
4,955,13,142,98,240,1.0,0
1,145,15,772,739,1511,0.4864864864864865,1
1,382,46,1506,274,1780,0.8206388206388207,1
1,399,2,2,2,4,1.0,0
1,435,13,342,182,524,0.9787234042553191,1
1,549,7,64,59,123,0.0,1
1,552,1,2,11,13,0.0,0
1,562,1,23,0,23,1.0,0
1,610,10,25,87,112,0.0,0
1,614,81,64,6392,6456,0.08063404548587182,0
2,209,2,3,14,17,1.0,0
2,462,12,194,175,369,1.0,0
2,596,10,192,48,240,0.8676470588235294,0
2,680,11,85,96,181,0.0,0
3,165,7,59,11,70,1.0,0
3,167,5,109,12,121,1.0,0
3,170,80,6382,0,6382,0.9193659545141282,0
3,187,63,2617,668,3285,0.9097320169252469,1
3,204,4,13,24,37,1.0,0
3,439,48,134,118,252,1.0,1
3,892,7,144,5,149,0.8235294117647058,0
0,169,20,65,567,632,0.0,0
0,258,13,105,51,156,1.0,0
0,353,16,127,6,133,1.0,1
1,382,4,14,2,16,1.0,1
1,552,1,2,11,13,0.0,0
1,486,39,943,1305,2248,0.0,0
1,546,1,8,1,9,1.0,0
1,549,4,191,45,236,1.0,1
1,556,5,54,0,54,1.0,0
1,559,61,1168,1357,2525,0.0,0
2,124,3,74,2,76,0.54,0
2,372,1,14,3,17,0.0,0
2,381,8,151,94,245,1.0,1
2,583,2,22,0,22,1.0,0
3,207,1,2,1,3,0.0,0
2,224,1,7,0,7,1.0,0
3,374,3,21,2,23,1.0,0
3,383,1,2,0,2,1.0,1
4,511,1,5,4,9,1.0,1
4,536,8,151,73,224,0.88,1
0,444,1,7,1,8,1.0,1
1,160,2,28,3,31,0.8888888888888888,0
1,295,5,6,6,12,1.0,0
1,485,2,6,2,8,0.5,0
1,902,1,23,2,25,0.0,0
2,641,12,153,58,211,0.9814814814814815,0
3,178,16,138,87,225,0.325,1
3,412,90,4,408,412,0.0,0
3,414,5,29,17,46,1.0,0
3,659,7,93,64,157,0.2727272727272727,1
3,677,1,12,5,17,1.0,0
3,686,1,1,8,9,1.0,0
4,140,2,9,17,26,0.0,0
4,487,15,164,174,338,1.0,1
0,710,4,88,1,89,0.22058823529411764,0
1,120,7,43,23,66,1.0,0
1,269,1,3,2,5,0.0,0
1,378,3,6,2,8,0.0,1
1,393,26,190,171,361,0.0,1
1,395,2,13,2,15,1.0,0
1,738,1,2,0,2,1.0,0
1,739,1,12,2,14,1.0,0
2,400,3,9,15,24,0.5,0
2,583,19,183,83,266,0.0,1
3,279,6,83,91,174,1.0,0
3,461,11,87,63,150,0.0,1
3,509,3,93,129,222,1.0,0
3,563,7,40,21,61,0.75,0
3,571,2,16,1,17,1.0,0
3,746,10,24,2,26,1.0,1
4,140,8,86,51,137,1.0,1
4,423,6,25,60,85,0.0,1
4,730,5,21,28,49,1.0,0
5,441,10,312,36,348,0.8586387434554974,0
1,569,20,795,97,892,0.871900826446281,1
1,667,12,3,720,723,0.25274725274725274,0
3,305,1,7,3,10,0.0,1
3,365,5,18,3,21,0.0,0
3,365,5,53,22,75,1.0,0
3,545,3,17,11,28,1.0,1
0,479,36,452,257,709,1.0,1
0,581,36,452,257,709,1.0,0
0,632,5,44,37,81,1.0,0
0,675,14,81,89,170,0.15384615384615385,0
0,695,4,21,2,23,0.0,1
1,200,1,0,7,7,1.0,0
1,345,5,11,5,16,0.6,0
1,450,1,47,6,53,1.0,0
2,384,7,81,31,112,0.9811320754716981,1
3,588,1,10,1,11,1.0,1
3,887,1,3,11,14,0.0,0
3,118,5,27,0,27,1.0,0
4,120,1,4,1,5,1.0,0
4,197,2,4,6,10,1.0,0
4,528,2,36,36,72,1.0,1
4,625,5,55,22,77,1.0,0
5,823,1,32,1,33,1.0,0
0,205,1,3,11,14,1.0,0
0,313,2,33,7,40,0.7272727272727273,1
0,332,1,1,1,2,1.0,0
0,339,3,28,4,32,1.0,1
0,343,2,23,24,47,1.0,0
0,483,14,94,185,279,0.0,0
0,499,1,3,6,9,0.0,0
0,508,1,6,0,6,1.0,0
0,539,1,4,3,7,1.0,0
0,556,2,17,0,17,1.0,0
0,584,1,96,86,182,1.0,0
0,664,2,5,6,11,1.0,0
1,160,4,29,3,32,0.6190476190476191,1
1,422,1,4,0,4,0.0,1
1,430,1,2,6,8,1.0,0
1,479,5,137,11,148,0.5909090909090909,1
1,552,8,8,52,60,0.23809523809523808,1
1,600,11,567,247,814,1.0,1
2,368,14,296,111,407,0.0,0
2,383,11,29,28,57,1.0,0
3,547,2,30,3,33,0.3333333333333333,0
4,129,3,138,26,164,1.0,1
0,202,9,153,53,206,1.0,0
0,209,44,1147,1163,2310,1.0,1
0,211,20,350,168,518,0.3870967741935484,1
0,410,6,29,20,49,1.0,1
0,471,4,43,15,58,0.0,1
0,474,1,43,40,83,0.0,0
0,535,4,54,118,172,1.0,1
0,561,2,75,4,79,1.0,0
0,568,2,26,11,37,1.0,0
1,179,2,96,0,96,0.4807692307692308,1
1,547,4,126,165,291,0.0,1
1,575,1,6,4,10,0.0,0
1,715,2,8,6,14,1.0,0
1,817,2,5,3,8,1.0,0
2,346,3,96,0,96,1.0,0
2,702,4,13,7,20,1.0,0
3,612,16,123,110,233,1.0,1
4,838,4,19,2,21,1.0,0
4,840,25,1339,1126,2465,1.0,1
5,367,6,31,52,83,0.36363636363636365,1
6,826,9,9,13,22,0.0,0
6,138,1,0,1,1,0.0,0
0,409,2,17,36,53,0.0,1
1,150,5,143,57,200,1.0,1
1,238,6,73,41,114,0.0,0
1,357,5,82,16,98,1.0,1
1,359,1,5,6,11,0.0,0
2,149,10,80,149,229,0.0,1
2,736,13,59,126,185,1.0,0
2,737,10,75,89,164,1.0,1
2,783,1,3,0,3,1.0,0
3,134,18,158,230,388,1.0,1
3,374,1,6,1,7,1.0,0
3,374,1,3,2,5,1.0,0
3,421,6,4,80,84,0.0,0
3,461,2,5,42,47,0.0,1
3,501,2,7,4,11,1.0,0
3,550,1,8,6,14,1.0,1
3,555,1,0,10,10,0.0,0
3,648,6,53,80,133,0.1111111111111111,1
4,302,1,155,0,155,1.0,0
4,708,4,28,132,160,0.25396825396825395,0
4,725,2,17,9,26,1.0,0
5,112,4,77,127,204,1.0,0
5,433,4,2,68,70,0.0,0
6,300,6,56,55,111,1.0,1
6,307,3,150,126,276,1.0,0
6,337,1,0,3,3,1.0,0
1,760,4,705,697,1402,1.0,0
2,105,7,218,45,263,0.4057971014492754,0
2,130,14,195,384,579,0.0,1
2,132,5,4,70,74,0.0,0
2,174,1,14,0,14,1.0,0
2,758,37,870,63,933,1.0,0
2,760,11,175,107,282,1.0,0
2,760,21,1523,930,2453,1.0,1
2,841,12,412,339,751,1.0,1
3,330,6,92,46,138,0.631578947368421,1
3,478,1,1,15,16,0.0,0
3,493,3,22,31,53,0.0,0
3,509,3,23,8,31,1.0,0
3,582,1,96,91,187,1.0,0
4,152,6,75,62,137,1.0,1
4,214,12,53,162,215,0.4230769230769231,0
4,443,6,41,50,91,0.5714285714285714,0
4,443,6,74,9,83,1.0,1
4,932,15,97,60,157,0.0,0
4,942,5,13,6,19,0.16666666666666666,0
6,429,3,33,2,35,1.0,0
6,487,3,3,1,4,1.0,0
6,604,2,37,30,67,1.0,0
0,336,5,25,5,30,0.75,0
0,336,7,66,22,88,0.8571428571428571,0
0,371,1,28,12,40,1.0,0
0,401,1,2,5,7,0.0,0
0,789,1,27,0,27,0.0,0
0,790,3,54,57,111,1.0,0
0,790,14,70,29,99,1.0,0
0,805,4,24,0,24,1.0,0
1,152,3,29,10,39,0.0,0
1,180,2,21,1,22,1.0,0
1,367,1,17,15,32,0.0,0
1,657,2,19,5,24,1.0,0
1,686,4,0,59,59,0.0,0
2,139,4,31,33,64,0.7142857142857143,1
2,179,6,132,32,164,0.8571428571428571,1
2,193,3,58,3,61,1.0,0
2,298,1,7,5,12,1.0,0
2,333,7,89,67,156,0.35294117647058826,0
2,360,5,12,22,34,0.0,0
2,435,11,37,94,131,0.0,0
2,436,2,10,2,12,1.0,0
2,463,1,7,2,9,1.0,0
2,752,3,6,9,15,0.0,0
3,316,1,8,1,9,1.0,0
4,206,336,4613,4293,8906,1.0,0
4,928,7,17,43,60,0.4166666666666667,0
0,591,17,471,45,516,1.0,0
0,934,1,4,9,13,1.0,0
1,388,5,454,252,706,1.0,1
1,395,10,183,22,205,0.7627118644067796,1
1,420,4,2,352,354,0.7887323943661971,0
1,624,1,34,3,37,1.0,0
2,419,5,11,10,21,1.0,0
2,431,72,306,233,539,1.0,1
2,447,7,31,18,49,1.0,0
2,678,9,191,21,212,0.746031746031746,0
2,683,1,14,0,14,1.0,0
3,137,1,0,2,2,1.0,0
3,151,70,4515,2371,6886,0.9087591240875912,1
3,571,1,24,8,32,1.0,0
4,145,1,27,36,63,1.0,0
6,64,1,5,4,9,1.0,0
0,354,1,2,8,10,0.0,0
0,361,1,38,40,78,1.0,0
0,434,3,121,1,122,0.3170731707317073,0
1,185,4,100,79,179,1.0,0
1,401,7,78,71,149,1.0,1
1,528,1,40,21,61,1.0,0
2,209,14,192,194,386,0.0,0
2,284,3,51,7,58,0.28,0
2,554,4,36,7,43,0.125,0
2,567,1,7,10,17,0.0,1
3,151,3,10,19,29,0.0,0
3,290,1,29,11,40,1.0,0
3,433,1,0,4,4,1.0,0
3,627,1,14,13,27,1.0,0
3,732,3,15,15,30,1.0,0
3,735,5,98,104,202,0.9642857142857143,1
3,740,9,13,7,20,1.0,0
4,143,3,17,2,19,0.6363636363636364,0
4,214,5,17,43,60,0.07142857142857142,1
4,464,1,0,8,8,0.0,0
4,629,1,4,0,4,1.0,0
5,892,3,44,45,89,0.0,1
0,550,2,2,10,12,0.0,0
0,581,2,8,2,10,1.0,0
0,584,1,6,10,16,1.0,0
1,137,3,77,15,92,0.575,1
1,446,3,46,33,79,1.0,1
2,125,13,61,160,221,0.9090909090909091,0
2,864,9,21,19,40,1.0,0
3,145,15,209,241,450,1.0,1
3,181,2,43,40,83,0.0,0
3,202,1,2,5,7,0.0,0
3,203,1,5,16,21,0.0,0
3,206,9,84,362,446,0.0,0
3,372,1,56,41,97,0.0,0
3,571,4,48,65,113,1.0,0
5,151,2,372,115,487,1.0,1
5,154,1,77,33,110,1.0,1
5,163,1,74,55,129,1.0,1
5,222,4,7,3,10,1.0,0
5,320,6,136,57,193,0.46,0
6,515,8,379,123,502,0.7714285714285715,0
6,728,1,2,10,12,1.0,0
0,127,4,16,31,47,0.058823529411764705,0
0,515,2,382,201,583,1.0,1
0,524,4,222,68,290,1.0,0
1,472,1,26,4,30,1.0,1
1,496,1,21,2,23,1.0,0
2,1021,1,7,6,13,0.0,0
2,168,1,16,9,25,1.0,0
4,361,1,3,2,5,1.0,0
4,545,2,32,33,65,1.0,1
4,552,1,83,65,148,1.0,1
6,351,1,20,30,50,1.0,0
1,526,24,373,110,483,1.0,1
1,909,2,42,21,63,1.0,0
2,964,1,28,19,47,1.0,0
3,348,3,15,8,23,1.0,0
3,491,2,47,0,47,1.0,0
3,510,1,17,5,22,1.0,0
3,539,1,6,13,19,0.0,0
4,146,7,57,29,86,0.6,1
6,380,1,5,0,5,0.0,1
1,112,2,25,3,28,1.0,1
1,115,1,8,6,14,0.0,0
1,117,5,43,55,98,1.0,0
1,144,7,170,4,174,1.0,0
1,228,1,12,8,20,0.0,0
1,371,1,7,5,12,1.0,0
2,431,2,5,4,9,1.0,0
4,592,3,48,0,48,0.875,0
0,418,9,27,39,66,0.9411764705882353,0
0,483,5,74,15,89,0.2826086956521739,1
1,1000,1,3,0,3,1.0,0
1,481,1,2,1,3,1.0,0
3,506,6,131,218,349,1.0,0
3,546,23,657,142,799,0.9120879120879121,1
3,608,2,2,4,6,1.0,0
3,612,20,1854,0,1854,0.609375,0
3,681,1,10,8,18,0.0,0
3,735,7,448,6,454,0.675,1
4,141,7,82,44,126,1.0,0
4,218,5,58,4,62,1.0,0
4,410,2,13,7,20,0.5,1
5,737,37,6762,0,6762,0.980276134122288,0
0,151,19,810,3,813,1.0,1
0,235,28,3258,0,3258,0.8233310856372218,1
0,869,3,131,97,228,0.5853658536585366,0
0,882,4,168,89,257,1.0,0
3,452,25,335,1695,2030,0.15681233933161953,0
3,507,15,320,7,327,0.6702127659574468,1
3,518,9,95,76,171,1.0,0
3,674,21,396,748,1144,0.0,1
4,228,4,16,9,25,1.0,0
4,292,2,113,95,208,0.7272727272727273,0
4,298,4,9,9,18,0.0,0
4,411,10,138,113,251,0.7857142857142857,0
4,416,1,9,5,14,1.0,0
4,422,8,242,37,279,0.6041666666666666,1
4,416,1,9,5,14,1.0,0
4,478,1,52,11,63,0.0,0
4,554,20,1288,148,1436,0.9181585677749361,1
5,311,15,811,158,969,1.0,0
5,311,15,811,158,969,1.0,0
0,873,1,48,57,105,0.7777777777777778,0
1,855,4,115,19,134,0.52,1
2,150,2,18,1,19,1.0,0
2,176,7,1163,778,1941,0.3284132841328413,0
2,724,1,1,3,4,0.0,0
2,956,6,729,1,730,0.9533527696793003,0
4,197,10,60,43,103,1.0,0
0,164,3,41,6,47,1.0,0
1,377,1,11,0,11,0.0,0
1,388,877,29940,13934,43874,1.0,0
1,467,876,13907,29913,43820,0.0,0
1,561,2,55,1,56,1.0,0
3,182,1,136,75,211,1.0,0
0,280,3,78,4,82,1.0,0
1,397,2,83,41,124,1.0,0
4,622,1,0,1,1,0.0,0
6,596,2,98,140,238,0.14634146341463414,1
1,140,8,46,56,102,0.25,0
1,160,13,415,1,416,0.8865248226950354,0
1,371,15,636,30,666,1.0,0
2,198,2,17,2,19,1.0,0
4,149,141,1794,1582,3376,0.8529411764705882,0
4,196,1,3,1,4,1.0,0
4,214,21,763,292,1055,0.437984496124031,1
4,217,15,243,76,319,0.09333333333333334,0
4,219,16,30,28,58,0.16666666666666666,0
1,166,14,673,0,673,0.9586466165413534,0
2,175,1,12,1,13,0.0,0
1,525,5,106,14,120,0.873015873015873,0
2,167,1,0,4,4,0.0,0
2,182,16,180,114,294,0.0,0
2,327,2,10,0,10,1.0,0
2,428,3,73,0,73,1.0,0
4,174,13,69,85,154,1.0,1
4,180,1,16,0,16,1.0,0
4,361,1,6,1,7,1.0,0
4,371,2,37,4,41,1.0,0
4,376,3,67,32,99,1.0,0
4,474,5,54,42,96,0.0,0
0,546,4,165,0,165,0.7808219178082192,0
0,581,3,7,6,13,1.0,0
0,935,1,1,1,2,1.0,0
1,417,24,633,405,1038,1.0,1
1,472,1,1,0,1,1.0,0
1,527,1,12,14,26,0.0,0
3,127,15,775,3,778,1.0,0
6,409,1,30,11,41,1.0,1
6,420,4,18,24,42,0.0,1
6,433,21,452,48,500,1.0,1
6,465,13,38,15,53,0.0,0
0,146,28,1449,0,1449,1.0,0
0,381,30,6668,51,6719,0.8413318025258324,1
0,385,2,55,35,90,0.125,0
2,148,11,1,650,651,0.0,0
2,171,13,131,422,553,0.0,0
2,505,18,4051,3,4054,0.7690227887215141,1
2,562,1,13,8,21,0.0,1
3,863,10,510,1,511,1.0,1
4,301,1,3,1,4,0.0,0
4,618,2,5,3,8,1.0,0
6,155,9,26,20,46,1.0,0
6,164,11,69,51,120,1.0,0
6,167,1,1,18,19,0.0,0
6,513,199,1500,1089,2589,0.0,1
0,342,44,320,335,655,0.0,0
0,486,98,546,682,1228,0.875,1
0,903,3,101,1,102,0.7083333333333334,0
0,954,45,305,338,643,0.0,1
1,180,9,356,0,356,1.0,0
1,191,13,664,0,664,0.9255813953488372,0
2,270,1,0,17,17,1.0,0
2,395,2,46,6,52,0.896551724137931,1
2,543,1,2,0,2,0.0,0
3,539,1,16,8,24,1.0,0
4,184,1,17,8,25,1.0,0
4,372,1,13,3,16,1.0,0
4,463,6,176,1,177,1.0,1
4,474,1,1,3,4,1.0,0
4,478,6,497,5,502,1.0,0
0,119,17,165,85,250,1.0,1
1,386,31,734,174,908,1.0,1
1,394,3,17,6,23,0.0,0
1,410,3,20,16,36,0.0,0
2,405,11,426,24,450,0.7012195121951219,1
2,451,5,67,6,73,1.0,0
3,139,130,1797,1639,3436,0.0,1
3,200,1,9,2,11,0.0,1
3,450,1,21,21,42,1.0,0
3,450,1,16,13,29,1.0,0
3,489,1,1,0,1,0.0,0
3,580,1,8,1,9,0.0,0
3,636,1,11,11,22,1.0,0
4,177,1,18,0,18,1.0,0
4,404,2,39,6,45,1.0,1
4,409,3,65,29,94,1.0,1
4,414,8,761,0,761,0.7819148936170213,0
4,777,2,11,8,19,1.0,0
4,950,1,10,0,10,1.0,0
0,151,9,135,230,365,0.0,1
0,522,2,11,0,11,1.0,0
0,572,2,4,6,10,0.0,0
2,125,1,0,4,4,1.0,0
4,296,12,67,36,103,1.0,0
6,1036,63,260,269,529,0.0,0
6,1038,3,300,0,300,1.0,0
0,300,4,12,28,40,0.3333333333333333,0
0,301,2,13,2,15,1.0,0
0,303,58,691,579,1270,0.8222222222222222,1
0,487,36,761,184,945,1.0,1
0,504,2,51,2,53,1.0,0
0,543,41,239,126,365,0.9090909090909091,0
1,473,1,0,1,1,0.0,0
1,569,3,121,33,154,0.35,0
1,589,2,2,12,14,0.3333333333333333,0
1,607,3,18,8,26,0.0,0
1,609,1,3,4,7,0.0,0
2,463,9,109,123,232,0.42857142857142855,0
2,597,2,16,7,23,0.0,1
2,641,21,108,112,220,0.3333333333333333,0
3,554,17,212,105,317,1.0,0
0,536,3,9,8,17,0.0,0
1,341,3,8,9,17,1.0,0
2,549,1,38,39,77,1.0,0
4,1002,1,25,92,117,0.0,0
5,332,1,13,13,26,1.0,0
0,119,46,3333,3340,6673,0.0,0
0,192,195,14252,3100,17352,0.9637454355764214,1
0,801,2,20,1,21,1.0,0
1,519,1,23,9,32,1.0,0
2,143,4,24,20,44,1.0,0
2,145,11,71,21,92,1.0,0
2,179,2,17,64,81,0.0,0
2,302,21,112,108,220,0.6666666666666666,0
2,339,14,113,82,195,1.0,0
2,360,6,248,0,248,0.34831460674157305,0
2,367,2,6,20,26,0.0,0
2,386,7,52,27,79,0.0,1
2,439,10,188,84,272,0.2857142857142857,1
2,476,1,59,13,72,1.0,0
2,549,218,1845,1367,3212,1.0,1
3,194,3,30,4,34,1.0,0
3,227,7,59,4,63,1.0,0
3,413,7,166,12,178,1.0,0
4,459,2,11,19,30,1.0,0
4,524,5,59,1,60,1.0,0
0,174,1,34,6,40,1.0,0
0,683,4,3459,6,3465,0.7663865546218488,0
1,137,26,794,1661,2455,0.3194444444444444,1
1,579,1,18,6,24,0.0,0
1,582,1,139,0,139,1.0,0
2,163,3,90,0,90,1.0,0
2,897,2,105,30,135,0.8064516129032258,0
3,99,21,622,61,683,0.8906882591093117,1
3,411,2,16,1,17,1.0,0
3,560,23,204,254,458,0.0,0
3,563,9,202,38,240,0.828125,0
4,87,2,28,12,40,1.0,0
4,570,9,126,54,180,1.0,0
1,193,1,3,1,4,1.0,0
1,388,5,161,34,195,1.0,0
1,483,2,55,2,57,1.0,1
1,485,3,26,17,43,0.0,0
1,511,1,31,0,31,1.0,0
1,624,121,157,144,301,1.0,0
3,210,42,27,496,523,0.2972972972972973,0
3,350,44,168,520,688,0.34591194968553457,0
3,378,4,128,11,139,1.0,0
3,679,3,84,34,118,1.0,0
4,115,1,1,3,4,0.0,0
4,126,5,104,49,153,1.0,1
0,165,2,2,1,3,1.0,1
0,171,1,2,0,2,1.0,1
0,358,2,21,3,24,1.0,0
1,537,2,19,4,23,1.0,0
1,594,3,869,852,1721,0.7692307692307693,0
2,110,2,10,2,12,1.0,0
2,144,1,6,9,15,1.0,0
2,187,2,29,3,32,1.0,1
2,195,1,11,2,13,1.0,0
2,389,1,384,381,765,1.0,0
2,454,1,2,5,7,0.0,0
3,130,5,72,23,95,1.0,0
3,220,3,259,0,259,0.9402985074626866,0
3,225,2,12,0,12,0.5555555555555556,0
3,884,4,3,16,19,0.0,0
4,181,2,13,5,18,1.0,0
2,149,2,12,0,12,0.4,0
0,411,52,148,132,280,1.0,0
0,488,5,52,4,56,1.0,0
0,514,1,1,0,1,0.0,0
0,672,1,2,1,3,0.0,0
1,465,4,978,27,1005,0.9174757281553398,0
3,165,19,67,34,101,1.0,0
3,179,2,7,0,7,0.5,0
4,134,37,1704,1734,3438,0.0,1
5,356,13,51,45,96,1.0,1
5,470,6,34,14,48,1.0,1
0,464,14,11,1204,1215,0.0,0
2,187,9,92,56,148,1.0,0
2,385,9,6,39,45,0.0,0
2,424,3,4,3,7,0.0,0
2,749,2,17,2,19,1.0,0
3,435,3,7,3,10,0.2,0
3,814,1,2,0,2,0.0,0
5,360,1,11,2,13,1.0,0
5,380,6,55,2,57,1.0,0
1,535,1,2,1,3,1.0,0
3,162,229,1527,1914,3441,0.033707865168539325,1
3,168,11,320,3503,3823,0.24353920280332894,0
3,483,78,751,420,1171,0.9586206896551724,1
3,573,10,103,108,211,1.0,0
4,156,36,258,122,380,0.975,1
4,287,7,40,376,416,1.0,0
4,451,7,192,6,198,0.99,1
5,319,1,2,1,3,1.0,0
5,748,1,9,17,26,1.0,0
0,117,24,341,150,491,1.0,1
0,430,1,3,1,4,1.0,0
0,532,6,205,8,213,1.0,0
0,532,1,7,2,9,0.0,1
0,532,2,99,14,113,1.0,0
0,539,26,250,76,326,1.0,0
0,550,12,192,180,372,0.0,1
0,565,1,23,5,28,1.0,0
0,596,2,15,17,32,0.0,0
0,704,1,32,15,47,1.0,0
0,704,1,33,4,37,1.0,0
1,101,4,9,1,10,1.0,0
1,156,5,263,73,336,1.0,1
1,733,18,158,77,235,1.0,1
1,734,6,75,18,93,1.0,0
1,740,50,1718,7,1725,1.0,0
2,128,1,2,0,2,1.0,0
2,221,21,856,93,949,1.0,1
2,457,27,406,142,548,0.8444444444444444,1
2,627,17,136,21,157,1.0,1
2,883,2,12,6,18,0.0,0
3,203,20,270,112,382,1.0,0
4,174,3,6,31,37,0.0,0
4,190,66,756,623,1379,1.0,1
4,191,6,258,2,260,1.0,0
4,192,1,184,0,184,0.6666666666666666,0
4,391,11,180,197,377,1.0,1
4,439,3,9,4,13,1.0,0
4,439,6,145,2,147,1.0,0
4,470,4,41,48,89,0.0,0
4,562,10,57,23,80,1.0,0
4,577,4,5,2,7,1.0,0
5,1397,3,117,113,230,0.0,0
0,522,6,18,22,40,1.0,0
0,536,13,78,54,132,1.0,0
0,734,2,10,6,16,0.0,0
1,393,1,42,16,58,1.0,0
1,396,1,0,184,184,0.3333333333333333,0
1,404,2,61,5,66,1.0,0
1,422,1,66,37,103,0.07142857142857142,0
1,679,37,709,199,908,0.9569377990430622,1
2,154,10,119,81,200,0.0,0
2,292,3,78,2,80,1.0,0
2,294,40,728,185,913,0.5714285714285714,1
2,408,4,18,46,64,0.9285714285714286,0
2,430,3,7,21,28,0.0,0
2,434,1,2,0,2,1.0,0
2,493,9,142,11,153,1.0,1
2,505,8,70,7,77,0.875,0
3,192,3,25,6,31,1.0,0
3,548,1,144,0,144,0.574468085106383,0
4,109,14,802,16,818,1.0,0
4,159,8,172,76,248,1.0,1
4,177,5,15,27,42,0.0,0
4,424,8,82,21,103,1.0,1
4,401,31,717,253,970,0.44805194805194803,1
4,463,11,72,23,95,0.5,0
4,585,4,21,132,153,0.6122448979591837,1
0,963,4,263,101,364,0.5833333333333334,1
0,172,1,46,12,58,1.0,0
0,556,12,318,90,408,1.0,1
0,584,2,25,4,29,1.0,0
0,785,27,352,152,504,0.7023809523809523,1
1,1091,5,205,20,225,1.0,0
1,76,1,21,5,26,1.0,0
1,150,4,30,72,102,0.0,0
1,596,11,232,166,398,0.6538461538461539,1
2,564,90,1428,339,1767,1.0,0
2,574,11,386,12,398,1.0,1
3,526,7,415,44,459,0.9911894273127754,0
4,505,4,253,4,257,1.0,0
0,369,2,108,6,114,1.0,0
0,599,3,53,28,81,1.0,0
0,678,52,615,2707,3322,0.36644093303235514,1
1,170,1,3,0,3,1.0,0
1,343,6,53,78,131,0.8095238095238095,1
1,492,2,23,1,24,0.6666666666666666,0
1,551,1,3,0,3,1.0,0
1,563,4,243,166,409,0.05263157894736842,0
2,209,14,67,9,76,0.7352941176470589,0
2,772,1,1,0,1,0.0,0
3,399,4,22,0,22,0.42857142857142855,0
3,432,42,1398,110,1508,0.95,1
3,465,4,179,0,179,1.0,0
3,510,2,57,76,133,0.125,0
3,566,2,23,1,24,0.0,0
3,791,3,12,5,17,0.0,0
4,553,2,40,36,76,1.0,0
4,784,45,851,589,1440,0.8294573643410853,1
4,812,1,7,18,25,1.0,0
5,908,6,57,12,69,0.9259259259259259,0
5,939,22,230,91,321,0.46835443037974683,0
0,289,1,25,11,36,1.0,0
0,303,4,15,3,18,0.42857142857142855,0
1,166,10,81,58,139,0.0,0
2,382,1,27,16,43,0.0,0
2,399,3,39,1,40,1.0,0
0,510,1,3,0,3,1.0,0
1,116,1,5,0,5,0.0,0
1,118,1,2,0,2,1.0,0
1,470,91,2562,1231,3793,0.8301886792452831,1
1,547,1,8,3,11,0.6666666666666666,0
2,659,6,166,34,200,1.0,1
2,719,4,36,21,57,1.0,0
3,192,1,6,9,15,1.0,0
3,362,2,45,1,46,0.5555555555555556,0
3,362,2,45,1,46,0.5555555555555556,0
4,156,1,2,5,7,0.0,0
6,927,1,4,0,4,1.0,0
0,137,7,133,46,179,1.0,0
0,472,4,983,503,1486,0.6705426356589147,0
1,319,26,235,141,376,1.0,0
1,567,1,8,11,19,0.0,0
1,729,1,10,4,14,0.0,0
3,736,3,18,38,56,1.0,0
4,549,2,14,0,14,1.0,0
6,179,18,792,52,844,0.7146974063400576,1
6,180,13,266,28,294,1.0,1
6,181,3,9,10,19,0.0,0
6,362,1,1,126,127,0.9148936170212766,0
0,185,27,1407,406,1813,0.12705530642750373,1
0,434,3,0,39,39,0.0,0
0,443,10,333,0,333,0.5728155339805825,0
0,464,5,83,4,87,0.3125,0
0,177,1,2,0,2,1.0,0
1,714,1,7,0,7,0.0,0
2,359,9,69,75,144,0.5,0
2,668,19,991,881,1872,1.0,1
3,36,1,7,1,8,1.0,1
3,192,1,6,9,15,1.0,0
3,36,1,7,1,8,1.0,0
3,411,2,10,4,14,1.0,0
3,430,5,129,64,193,1.0,0
4,810,2,4,2,6,0.0,0
0,177,1,2,0,2,1.0,0
5,300,8,134,70,204,0.24390243902439024,1
5,416,5,47,15,62,1.0,0
5,797,274,6181,19187,25368,0.108125,1
0,298,49,421,98,519,1.0,1
0,479,301,6805,4510,11315,0.7320574162679426,0
0,607,1,13,5,18,0.6,0
0,772,19,364,306,670,0.0,1
1,175,1,203,0,203,0.7985074626865671,0
2,598,3,7,1,8,1.0,0
4,182,3,30,2,32,1.0,0
0,799,112,1139,1228,2367,0.53,1
1,946,18,184,208,392,0.3103448275862069,0
2,767,3,56,30,86,1.0,0
2,767,1,22,7,29,0.0,0
0,507,1,2,0,2,1.0,1
0,542,1,4,5,9,0.0,0
0,758,7,170,91,261,1.0,0
1,108,1,3,0,3,1.0,0
1,465,4,33,1,34,1.0,0
1,513,1,4,1,5,0.0,0
1,549,50,278,76,354,0.40384615384615385,0
1,561,2,0,127,127,0.0,0
1,665,42,74,73,147,0.0,0
2,207,2,13,16,29,0.6666666666666666,0
2,255,1,10,0,10,1.0,0
3,167,5,63,8,71,1.0,0
3,188,1,37,0,37,1.0,0
3,503,18,90,5,95,0.0,0
6,326,22,198,96,294,1.0,1
0,278,2,9,2,11,1.0,0
0,677,1,4,0,4,1.0,0
2,506,1,23,38,61,0.0,0
4,320,1,1,5,6,0.0,0
3,383,61,602,318,920,1.0,1
4,392,381,12947,3362,16309,0.985201702817758,1
4,614,28,65,53,118,1.0,0
6,904,9,358,222,580,0.42857142857142855,1
1,192,163,215,233,448,0.0,0
1,305,1,8,6,14,0.0,0
2,559,40,530,452,982,1.0,1
3,139,13,660,11,671,1.0,0
3,146,38,291,1620,1911,0.2112970711297071,0
3,314,97,8211,33,8244,0.9758406790728045,0
3,554,2,4,5,9,0.0,0
4,200,149,9144,1647,10791,1.0,0
4,330,149,1647,9144,10791,0.0,1
3,776,1,21,2,23,1.0,0
4,444,5,13,3,16,1.0,0
3,139,13,660,11,671,1.0,0
3,146,38,291,1620,1911,0.2112970711297071,1
6,151,1,9,1,10,1.0,0
0,356,1,4,2,6,1.0,0
0,562,17,79,84,163,1.0,1
0,893,2,171,142,313,1.0,0
0,894,1,8,4,12,1.0,0
0,907,1,1,6,7,0.0,0
6,341,2,51,6,57,1.0,0
6,620,8,42,23,65,0.9411764705882353,0
6,620,19,502,331,833,0.7241379310344828,0
0,865,15,173,46,219,1.0,0
1,104,4,22,20,42,1.0,0
1,325,12,230,192,422,0.6164383561643836,0
1,396,3,32,4,36,1.0,0
3,748,44,387,329,716,0.3695652173913043,1
3,928,3,15,4,19,1.0,0
4,797,1,3,3,6,0.0,0
4,282,3,110,7,117,1.0,0
1,195,1,12,14,26,1.0,0
2,190,60,1455,4072,5527,0.5300171526586621,0
2,201,1,3,3,6,0.0,0
3,411,4,7,60,67,0.0,1
3,417,4,15,6,21,1.0,0
5,349,1,8,3,11,0.0,0
5,379,14,288,87,375,0.9482758620689655,1
0,478,5,32,21,53,0.0,0
0,523,4,53,1,54,1.0,0
1,582,4,34,31,65,1.0,0
1,611,1,58,0,58,1.0,0
1,658,1,4,4,8,0.0,0
1,699,2,8,1,9,1.0,0
2,517,1,1,6,7,1.0,0
2,557,2,23,4,27,1.0,0
2,649,10,85,44,129,0.90625,1
2,718,5,73,1,74,0.5531914893617021,1
2,744,16,40,166,206,0.29365079365079366,1
2,745,2,10,2,12,0.0,0
2,758,1,27,21,48,1.0,0
4,161,2,56,21,77,1.0,0
1,356,14,228,200,428,0.9230769230769231,1
2,164,9,167,95,262,1.0,1
2,465,1,7,4,11,1.0,0
2,497,5,8,132,140,0.0,0
2,186,4,12,2,14,0.0,0
3,763,2,17,0,17,0.0,0
4,166,1,9,6,15,0.0,0
4,318,1,1,14,15,0.4,0
4,581,2,83,30,113,0.9583333333333334,0
4,863,2,17,1,18,0.375,0
4,959,4,56,82,138,1.0,0
5,882,1,3,0,3,0.0,0
6,628,1,12,10,22,1.0,0
0,242,2,5,1,6,0.0,0
2,442,3,18,13,31,1.0,1
2,559,17,710,0,710,0.9216589861751152,1
4,327,1,13,14,27,1.0,0
4,332,1,19,1,20,1.0,1
4,332,1,9,2,11,1.0,1
0,572,2,0,14,14,1.0,0
3,654,1,1,2,3,0.0,0
3,658,1,1,2,3,1.0,0
1,282,1,4,16,20,0.0,0
0,136,2,10,6,16,1.0,0
3,442,10,1301,1226,2527,1.0,1
3,558,7,72,10,82,0.8529411764705882,0
3,735,1,204,162,366,1.0,0
4,394,1,5,0,5,0.0,0
4,602,1,4,2,6,1.0,0
6,144,7,1268,1218,2486,1.0,1
1,803,2,14,1,15,1.0,0
4,213,3,77,18,95,1.0,0
4,242,4,46,0,46,1.0,0
4,261,2,25,1,26,0.0,0
4,448,1,2,1,3,0.0,1
4,470,3,44,24,68,0.0,0
4,491,2,47,0,47,0.9743589743589743,1
5,258,2,108,1,109,1.0,0
5,345,1,3,1,4,1.0,0
5,459,12,495,39,534,0.9828326180257511,0
5,478,3,146,125,271,1.0,0
0,555,6,45,11,56,0.3,0
1,339,3,157,12,169,0.782608695652174,0
1,583,11,362,72,434,0.9861111111111112,1
2,269,4,265,74,339,1.0,1
2,492,3,20,1,21,0.9473684210526315,0
3,199,2,7,7,14,1.0,0
3,556,1,19,29,48,0.0,0
4,259,4,127,66,193,1.0,0
4,580,2,41,1,42,1.0,0
5,759,2,3,1,4,1.0,0
6,293,2,25,33,58,0.0,0
6,333,21,71,44,115,0.14285714285714285,0
6,607,1,54,32,86,0.0,0
0,490,1,6,0,6,1.0,0
0,502,1,10,10,20,0.0,0
0,733,12,206,121,327,0.0,0
1,312,11,1,975,976,0.1183206106870229,0
0,735,192,16107,85,16192,0.9600840336134454,1
2,390,5,22,5,27,1.0,0
2,482,1,10,9,19,1.0,0
3,226,3,50,31,81,1.0,1
3,420,11,134,173,307,1.0,0
4,716,7,150,30,180,1.0,0
0,236,2,7,0,7,1.0,0
1,269,2,50,1,51,1.0,0
2,418,2,23,0,23,0.35294117647058826,0
3,163,7,34,23,57,0.5555555555555556,1
4,492,6,363,42,405,1.0,1
4,512,4,45,9,54,0.6666666666666666,0
4,530,163,2158,5111,7269,0.0,1
4,610,19,80,76,156,0.5555555555555556,0
4,669,2,10,0,10,0.0,0
4,710,1,30,21,51,0.0,1
5,633,1,0,2,2,0.0,0
6,620,2,24,16,40,0.0,0
0,573,2,6,7,13,0.0,0
2,509,1,1,1,2,1.0,0
3,781,1,12,16,28,1.0,0
4,455,1,143,15,158,1.0,0
2,509,1,1,1,2,1.0,0
3,781,1,12,16,28,1.0,0
4,455,1,143,15,158,1.0,0
2,573,1,9,3,12,0.0,0
3,217,1,1,7,8,0.0,0
4,212,2,18,30,48,0.0,0
4,375,1,86,0,86,0.13636363636363635,0
4,376,1,1,0,1,0.0,0
4,377,3,28,39,67,0.0,0
4,378,12,212,7,219,1.0,1
4,380,1,7,1,8,0.0,0
5,583,6,32,68,100,1.0,0
5,865,1,1,7,8,0.0,0
5,870,4,29,29,58,0.0,0
0,311,3,14,276,290,0.0,0
0,369,1,254,0,254,1.0,0
0,478,7,75,270,345,0.0,0
3,188,2,4,10,14,1.0,0
3,350,38,264,125,389,1.0,0
5,944,2,1,13,14,0.0,0
1,415,2,135,8,143,1.0,1
2,481,2,39,1,40,1.0,0
2,492,1,46,15,61,1.0,0
2,879,4,157,0,157,1.0,0
2,888,1,1,2,3,1.0,0
2,889,1,1,0,1,1.0,0
2,910,4,62,3,65,0.24,0
3,380,1,4,3,7,1.0,0
3,698,1,0,20,20,0.0,0
3,797,3,156,0,156,1.0,0
3,803,1,7,10,17,1.0,0
4,150,4,482,0,482,0.8957345971563981,0
4,278,2,21,1,22,0.6428571428571429,0
4,449,1,8,3,11,1.0,0
4,691,3,29,11,40,1.0,0
1,163,2,28,31,59,0.0,0
1,220,9,797,19,816,0.5240963855421686,0
0,290,1,7,1,8,1.0,0
4,409,1,7,1,8,0.0,0
4,474,1,348,23,371,1.0,0
4,490,1,28,22,50,1.0,0
6,548,3,1,4,5,0.0,0
0,384,1,348,23,371,1.0,0
0,490,4,746,486,1232,1.0,1
1,205,9,621,39,660,0.989010989010989,0
1,543,1,37,13,50,1.0,1
1,569,5,100,29,129,1.0,0
2,74,16,425,67,492,0.9873417721518988,1
4,372,13,210,18,228,0.5932203389830508,1
4,449,4,128,6,134,1.0,1
4,465,11,66,1,67,0.8529411764705882,0
2,496,3,4,6,10,0.0,0
2,527,4,177,1,178,0.3924050632911392,0
3,190,2,7,2,9,1.0,0
3,709,31,733,614,1347,1.0,0
4,294,1,10,5,15,1.0,0
4,578,1,5,10,15,0.0,0
4,579,31,614,733,1347,0.0,1
1,1049,6,34,23,57,1.0,1
0,702,1,7,1,8,1.0,0
5,1216,1,1,7,8,1.0,0
2,349,5,28,14,42,1.0,0
3,776,3,116,0,116,1.0,0
3,824,2,28,18,46,1.0,0
0,200,1,19,0,19,0.0,0
0,227,1,19,0,19,0.0,0
0,336,1,2,4,6,0.0,0
2,357,1,21,3,24,0.0,0
2,358,1,17,31,48,0.0,0
3,517,3,46,0,46,1.0,1
4,344,3,12,9,21,0.0,0
4,444,3,18,3,21,1.0,1
3,232,10,511,482,993,1.0,0
3,448,2,62,47,109,1.0,0
3,563,2,47,62,109,0.0,1
0,400,1,6,19,25,0.0,0
0,805,1,2,3,5,0.0,0
2,419,1,53,0,53,1.0,0
2,510,1,3,2,5,1.0,0
2,569,1,3,2,5,1.0,0
2,570,1,4,57,61,0.0,0
0,141,40,574,1304,1878,0.0,0
0,341,20,107,680,787,0.0,0
1,998,18,172,213,385,1.0,0
1,999,3,19,7,26,1.0,0
1,1049,5,34,10,44,0.0,0
1,920,1,1,3,4,1.0,0
3,857,1,24,4,28,1.0,0
6,972,2,7,1,8,1.0,0
6,858,1,6,1,7,1.0,0
0,402,6,128,7,135,1.0,0
0,555,25,1357,1129,2486,0.0,1
1,456,5,92,1,93,0.8484848484848485,0
2,302,1,1,2,3,0.0,0
2,346,2,33,9,42,0.9411764705882353,0
2,399,1,1,0,1,1.0,0
2,429,1,12,0,12,1.0,0
3,548,193,6842,3134,9976,1.0,1
4,264,61,1437,469,1906,0.6242038216560509,0
4,533,2,29,2,31,1.0,0
1,223,2,35,16,51,1.0,0
1,334,8,164,32,196,1.0,1
1,894,1,7,3,10,1.0,0
2,219,1,1,2,3,0.0,0
2,518,6,19,43,62,0.0,0
3,201,1,10,5,15,1.0,0
3,601,18,211,49,260,0.6944444444444444,0
1,1071,14,292,102,394,0.9166666666666666,0
1,574,8,74,96,170,0.0,0
3,131,9,106,34,140,0.045454545454545456,0
4,148,2,22,6,28,1.0,0
4,552,32,656,212,868,1.0,1
1,819,5,25,0,25,1.0,0
2,308,3,103,1,104,1.0,0
3,166,34,289,2101,2390,0.014028056112224449,0
3,548,3,22,3,25,1.0,0
4,576,4,105,86,191,0.0,0
0,440,13,81,50,131,0.0,1
0,455,4,56,2,58,1.0,0
0,493,2,21,2,23,0.06666666666666667,0
0,819,4,22,8,30,0.8461538461538461,0
1,1010,1,17,7,24,1.0,0
1,488,3,24,12,36,0.0,0
0,521,33,1139,1001,2140,0.76,0
1,299,4,27,22,49,1.0,0
3,232,10,544,550,1094,1.0,1
0,141,37,873,1430,2303,0.0,1
0,341,19,107,635,742,0.0,1
1,998,18,173,288,461,0.0,1
1,999,3,19,7,26,1.0,0
1,1049,5,34,10,44,0.0,1
4,264,60,1442,477,1919,0.6257928118393234,1
1,223,2,35,16,51,1.0,0
3,601,18,218,67,285,0.6944444444444444,1
1,1071,14,292,102,394,0.9166666666666666,1
4,552,32,692,247,939,1.0,1
1,819,5,25,0,25,1.0,0
3,166,34,471,2137,2608,0.02993348115299335,0
3,548,3,22,3,25,1.0,0
4,576,4,105,86,191,0.0,0
0,440,13,81,50,131,0.0,1
0,455,4,56,2,58,1.0,0
0,493,2,21,2,23,0.06666666666666667,1
0,819,4,22,8,30,0.8461538461538461,1
0,521,33,1139,1001,2140,0.7575757575757576,0
1,299,4,27,22,49,1.0,1
0,338,450,1916,59341,61257,0.14483789845714673,0
0,410,7,26,10,36,1.0,1
1,302,23,659,229,888,1.0,1
1,362,2,5,2,7,1.0,0
3,403,19,237,125,362,1.0,1
3,477,3,42,18,60,1.0,0
0,196,5,74,15,89,0.16666666666666666,0
3,587,32,925,446,1371,1.0,0
3,599,12,98,44,142,1.0,1
3,600,1,3,0,3,0.0,0
1,362,2,63,2,65,1.0,0
1,396,8,166,8,174,1.0,1
1,556,2,18,0,18,1.0,1
2,419,6,40,30,70,0.42857142857142855,1
1,374,2,21,2,23,1.0,0
1,650,11,102,29,131,0.9047619047619048,1
3,510,2,9,8,17,0.0,1
3,513,3,115,32,147,0.5813953488372093,0
3,541,5,30,13,43,1.0,1
3,596,4,8,4,12,1.0,0
1,791,7,84,65,149,0.0,0
4,471,3,39,17,56,1.0,0
0,547,2,1,7,8,0.0,0
4,390,3,5,8,13,0.0,0
4,390,9,182,39,221,0.5308641975308642,1
4,391,8,146,8,154,0.9117647058823529,1
0,519,8,44,26,70,0.6470588235294118,1
0,862,1,69,62,131,1.0,1
1,154,2,14,0,14,0.6,1
2,437,2,12,5,17,0.0,1
3,965,2,8,1,9,0.3333333333333333,0
3,319,2,22,9,31,1.0,0
4,395,2,8,6,14,1.0,0
4,617,7,34,7,41,1.0,0
0,432,112,3805,1139,4944,0.7474674384949349,1
0,653,4,33,57,90,0.6,0
1,345,6,48,15,63,0.9130434782608695,1
2,385,14,92,26,118,0.6086956521739131,1
2,914,1,14,28,42,1.0,0
1,372,1,13,6,19,1.0,0
1,405,7,48,110,158,0.0625,0
3,205,2,12,11,23,0.0,0
3,936,21,387,140,527,1.0,0
3,519,103,3524,2533,6057,0.7823529411764706,1
6,662,42,486,274,760,0.5309734513274337,0
4,484,14,137,34,171,0.10526315789473684,0
4,948,83,3396,173,3569,0.9093851132686084,1
3,490,7,18,11,29,1.0,0
5,462,1,5,2,7,0.0,0
5,492,29,1658,1,1659,0.9791666666666666,0
0,331,3,6,11,17,1.0,0
1,565,64,4475,17,4492,0.7119155354449472,1
1,568,1,0,1,1,0.0,0
3,887,1,33,33,66,1.0,1
1,428,6,83,201,284,0.28125,1
1,366,1,12,0,12,1.0,0
4,453,3,13,1,14,1.0,0
4,596,28,1029,962,1991,0.9512195121951219,0
0,326,3,227,7,234,1.0,0
2,877,4,25,17,42,0.6666666666666666,0
5,402,1,30,8,38,0.0,0
0,205,3,13,3,16,0.5714285714285714,1
0,514,7,40,30,70,0.0,1
1,137,9,29,7,36,0.8823529411764706,1
2,358,3,36,16,52,1.0,1
3,448,3,15,12,27,1.0,1
4,596,1,15,4,19,0.4444444444444444,0
6,563,2,18,0,18,1.0,0
1,329,2,19,2,21,0.0,0
3,533,5,67,15,82,0.0,0
1,446,3,16,16,32,0.0,0
3,549,2,6,3,9,0.0,0
1,457,4,45,41,86,1.0,0
1,711,58,5215,2,5217,0.8907324969647916,1
1,918,64,688,425,1113,0.5777777777777777,0
1,918,64,425,688,1113,0.4222222222222222,1
2,963,64,688,425,1113,0.5777777777777777,1
2,702,34,1989,953,2942,0.5924764890282131,1
3,400,1,3,8,11,1.0,1
3,520,3,11,8,19,0.0,0
3,687,5,26,24,50,1.0,0
4,400,3,6,14,20,0.0,0
3,891,1,1,0,1,1.0,0
4,114,1,7,0,7,0.5,0
4,134,1,9,3,12,1.0,0
1,364,9,147,54,201,0.3023255813953488,0
3,448,84,7359,9,7368,0.9203601108033241,1
4,712,3,70,131,201,0.7936507936507936,1
1,391,1,43,10,53,0.0,0
1,465,3,59,61,120,0.22727272727272727,1
1,412,4,38,16,54,0.6363636363636364,0
3,679,3,33,26,59,1.0,0
4,564,41,1926,842,2768,1.0,1
5,898,3,21,8,29,0.0,1
6,968,13,331,61,392,0.8095238095238095,1
6,479,9,1238,80,1318,0.707936507936508,1
0,412,1,4,1,5,1.0,0
1,433,32,199,891,1090,0.0,1
1,453,19,334,133,467,0.3333333333333333,1
2,128,2,11,15,26,0.0,0
3,682,9,241,21,262,1.0,0
3,695,1,15,28,43,1.0,0
4,422,3,6,2,8,1.0,0
4,745,108,5445,1263,6708,0.7802013422818792,1
0,356,14,191,37,228,0.8289473684210527,1
0,490,66,1320,478,1798,0.7993197278911565,1
0,822,1,4,6,10,0.0,0
4,151,7,47,16,63,1.0,0
4,153,1,5,0,5,1.0,0
4,290,7,15,9,24,1.0,0
1,553,20,1367,19,1386,0.7749576988155669,1
2,163,4,78,79,157,1.0,0
5,356,28,822,56,878,0.527536231884058,0
6,503,2,11,9,20,1.0,1
6,791,2,47,1,48,1.0,0
6,795,1,52,47,99,0.0,0
0,234,1,6,4,10,1.0,1
0,515,12,163,79,242,1.0,0
0,768,6,81,1,82,0.9523809523809523,0
1,377,37,202,98,300,1.0,1
2,586,1,3,0,3,1.0,0
2,936,1,13,31,44,0.0,0
4,92,2,254,0,254,1.0,0
4,587,2,258,0,258,1.0,0
5,554,1,81,0,81,1.0,0
1,365,1,7,1,8,1.0,0
1,374,327,6305,1829,8134,0.853170731707317,1
1,920,12,271,25,296,0.8076923076923077,1
3,561,1,98,39,137,1.0,0
3,563,5,102,144,246,1.0,1
4,145,6,52,42,94,1.0,1
4,462,1,6,3,9,1.0,0
4,520,18,783,182,965,0.5897435897435898,0
0,411,2,140,98,238,1.0,0
0,452,1,9,3,12,1.0,1
1,524,193,4686,2497,7183,0.9205020920502092,1
1,561,11,202,111,313,1.0,1
1,569,26,1025,604,1629,0.8609022556390977,1
1,604,2,15,0,15,0.0,1
1,663,1,0,4,4,0.0,0
1,961,13,502,0,502,1.0,0
2,983,58,107,2365,2472,0.09297912713472485,0
3,558,61,1162,692,1854,0.8842592592592593,1
4,967,26,522,182,704,0.8211920529801324,1
4,175,3,8,7,15,1.0,0
4,560,4,109,41,150,1.0,0
4,600,4,69,21,90,0.3783783783783784,0
4,859,11,233,50,283,0.6785714285714286,1
6,337,15,226,47,273,0.6142857142857143,0
2,177,1,67,65,132,0.0,0
2,486,2,28,16,44,0.45454545454545453,1
2,726,1,3,21,24,1.0,0
2,727,3,16,12,28,0.0,0
3,147,1,3,0,3,1.0,1
4,555,17,346,163,509,0.0,1
0,138,1,11,8,19,1.0,1
0,141,1,16,9,25,1.0,0
0,150,9,339,87,426,0.29381443298969073,1
1,224,7,52,37,89,1.0,1
2,166,4,11,5,16,1.0,0
2,713,11,149,64,213,0.3333333333333333,1
3,321,2,74,6,80,1.0,0
3,434,4,107,26,133,0.0,0
3,437,1,21,37,58,0.0,0
3,443,2,5,0,5,1.0,0
3,471,1,9,4,13,1.0,0
3,610,6,144,7,151,1.0,1
3,797,5,272,7,279,1.0,0
3,798,1,0,7,7,1.0,0
4,961,1,1,0,1,0.0,0
4,188,1,4,0,4,1.0,1
4,273,3,8,9,17,0.0,0
4,281,2,1,3,4,1.0,0
5,759,1,4,2,6,1.0,0
6,260,2,17,6,23,1.0,0
0,381,8,205,50,255,0.7721518987341772,1
0,391,1,4,3,7,1.0,0
0,401,8,56,13,69,0.4411764705882353,1
0,660,10,104,73,177,1.0,0
0,660,10,104,73,177,1.0,0
1,142,1,1,0,1,1.0,0
2,185,1,25,17,42,0.0,0
2,190,4,121,1,122,1.0,0
2,194,2,146,0,146,1.0,0
1,195,1,2,4,6,1.0,0
2,199,7,107,80,187,0.9545454545454546,0
2,199,7,43,19,62,1.0,0
3,164,1,8,5,13,0.0,0
3,170,1,5,1,6,0.0,0
4,216,2,12,2,14,0.4,0
4,319,6,35,37,72,0.25,0
4,331,22,215,71,286,0.6590909090909091,0
3,839,1,101,0,101,1.0,0
3,844,19,386,134,520,1.0,0
3,846,2,5,2,7,1.0,0
3,846,6,156,7,163,0.922077922077922,0
3,847,8,29,40,69,0.0,0
3,850,9,2075,0,2075,0.9252823631624674,0
3,853,5,1,196,197,0.0,0
4,120,2,36,9,45,1.0,1
4,246,2,23,16,39,1.0,0
4,248,1,9,1,10,1.0,0
5,253,1,1,0,1,1.0,0
5,254,11,324,162,486,0.96875,0
6,788,5,251,45,296,0.8309859154929577,0
6,792,4,111,14,125,1.0,0
6,793,1,2,5,7,0.0,0
6,795,2,337,112,449,1.0,0
6,798,2,35,24,59,1.0,0
6,805,2,11,5,16,1.0,0
6,118,8,542,0,542,1.0,0
0,134,2,15,5,20,1.0,0
0,136,3,74,6,80,1.0,1
0,243,1,6,1,7,1.0,0
1,384,7,53,32,85,0.5333333333333333,0
1,385,4,250,0,250,1.0,0
1,451,1,66,0,66,1.0,0
1,513,3,22,12,34,1.0,0
1,689,1,3,0,3,1.0,0
1,887,30,1105,57,1162,0.9725776965265083,1
1,888,3,100,1,101,1.0,0
2,565,3,27,6,33,0.8461538461538461,1
3,666,13,288,510,798,0.0,0
4,137,7,502,25,527,0.9616724738675958,1
4,137,3,33,36,69,1.0,1
4,137,4,230,217,447,0.0,1
3,138,1,75,9,84,1.0,0
4,700,12,596,44,640,0.9342105263157895,0
0,284,8,234,71,305,0.9696969696969697,0
0,294,3,57,7,64,1.0,0
0,410,24,1269,933,2202,0.3526315789473684,1
0,444,1,53,45,98,0.0,0
1,202,4,55,9,64,0.9090909090909091,1
1,321,1,10,8,18,1.0,0
1,363,1,4,3,7,1.0,0
2,161,1,2,0,2,1.0,0
2,161,2,19,3,22,0.0,1
2,163,54,4025,16,4041,0.804932735426009,0
2,478,1,37,0,37,1.0,0
3,580,1,17,3,20,1.0,0
4,152,2,2,2,4,1.0,0
3,155,2,3,2,5,0.0,0
4,178,1,2,0,2,1.0,0
4,587,5,189,15,204,1.0,1
3,435,3,72,2,74,1.0,0
3,462,3,161,54,215,1.0,0
4,154,1,5,1,6,1.0,0
4,402,1,0,3,3,1.0,0
6,179,1,7,4,11,1.0,0
6,230,1,59,79,138,0.0,0
1,203,1,7,5,12,1.0,0
1,397,1,1,0,1,1.0,0
1,741,1,24,2,26,1.0,0
1,743,9,535,2,537,1.0,0
1,837,5,67,69,136,0.0,1
1,944,1,14,6,20,1.0,0
2,646,3,11,4,15,0.0,0
2,646,10,412,17,429,0.26066350710900477,1
3,365,1,91,0,91,1.0,0
3,365,1,5,2,7,0.0,0
3,663,1,77,56,133,0.125,0
3,664,2,2,0,2,0.5,0
4,285,12,242,291,533,0.018518518518518517,1
4,286,2,38,20,58,0.5625,0
4,287,2,7,21,28,0.0,0
4,288,5,145,79,224,0.0,1
3,289,20,811,121,932,1.0,0
5,871,1,5,0,5,1.0,0
6,858,39,799,556,1355,1.0,0
6,859,4,32,26,58,0.6666666666666666,0
0,226,16,180,31,211,1.0,0
0,400,1,32,33,65,0.0,0
1,205,34,1754,61,1815,0.8695652173913043,1
1,697,7,116,43,159,0.0,0
1,142,3,4,4,8,0.0,0
2,256,1,43,0,43,1.0,0
2,271,4,27,16,43,1.0,1
2,281,1,2,0,2,1.0,0
2,477,18,743,52,795,0.6785714285714286,1
2,553,1,16,4,20,1.0,0
3,275,2,10,32,42,1.0,0
3,418,13,165,91,256,0.0,1
3,823,10,87,83,170,0.0,1
3,823,2,21,15,36,1.0,0
4,598,1,12,26,38,0.0,1
6,582,3,39,9,48,0.9333333333333333,0
6,583,4,16,4,20,1.0,0
6,590,3,130,7,137,0.8833333333333333,1
6,844,3,78,21,99,0.8333333333333334,0
6,863,10,317,252,569,1.0,1
6,872,10,644,3,647,1.0,0
6,874,2,6,15,21,0.5,0
6,875,11,531,0,531,1.0,0
0,372,12,263,16,279,1.0,0
1,467,3,29,9,38,0.0,1
1,776,2,188,2,190,1.0,0
3,580,3,19,24,43,0.0,0
3,649,1,7,5,12,0.0,0
3,660,6,77,5,82,0.9090909090909091,0
4,221,2,10,2,12,1.0,0
5,516,1,3,4,7,0.0,0
0,168,5,72,32,104,0.7575757575757576,1
0,293,2,7,1,8,1.0,0
0,303,42,831,506,1337,1.0,0
0,317,2,166,4,170,1.0,0
0,324,15,611,129,740,1.0,0
0,340,1,1,0,1,0.0,0
0,345,6,128,3,131,1.0,0
0,346,2,101,0,101,1.0,0
0,359,2,30,26,56,0.0,0
0,396,7,329,0,329,1.0,0
0,401,13,240,106,346,0.0,1
0,463,7,0,329,329,0.0,0
1,346,1,0,2,2,0.0,0
2,437,1,24,3,27,1.0,0
2,438,8,340,2,342,1.0,0
3,723,9,94,39,133,1.0,0
4,133,14,440,31,471,1.0,0
4,348,2,2,5,7,1.0,0
4,382,1,71,0,71,1.0,0
4,388,3,8,28,36,0.058823529411764705,0
4,392,13,551,18,569,1.0,0
4,393,1,15,1,16,1.0,0
4,394,2,9,4,13,1.0,0
4,480,3,126,28,154,0.7164179104477612,1
0,158,7,106,13,119,1.0,1
0,158,1,7,2,9,1.0,0
0,159,1,10,1,11,1.0,0
0,650,15,99,97,196,0.0,1
1,58,52,2099,439,2538,1.0,1
1,141,14,71,189,260,1.0,0
1,170,4,208,62,270,0.96875,0
1,681,31,1347,101,1448,1.0,0
2,114,4,27,62,89,1.0,0
2,355,10,420,26,446,1.0,1
2,441,1,11,1,12,1.0,0
2,447,8,339,2,341,1.0,0
2,560,7,81,0,81,0.16666666666666666,0
3,368,9,450,18,468,0.65234375,1
3,594,302,5188,1895,7083,0.8980797636632201,1
4,780,104,1710,753,2463,0.775390625,1
4,797,1,18,20,38,0.0,1
6,290,3,32,3,35,1.0,0
0,444,63,919,325,1244,0.6069651741293532,1
0,447,1,6,2,8,1.0,0
0,447,2,38,8,46,1.0,0
0,544,1,15,12,27,1.0,0
0,886,27,602,73,675,1.0,0
1,185,2,30,9,39,1.0,0
2,13,2,31,1,32,1.0,0
2,148,12,71,59,130,0.0,0
2,182,2,84,0,84,0.7857142857142857,0
2,207,5,40,2,42,1.0,0
2,275,1,31,29,60,0.0,0
2,303,3,11,41,52,0.9259259259259259,0
2,309,1,8,6,14,0.0,0
2,311,3,168,31,199,0.6354166666666666,0
2,341,8,97,138,235,0.0,0
2,363,1,9,13,22,0.0,0
2,367,5,201,55,256,1.0,0
2,466,9,71,7,78,0.96875,1
2,499,6,82,29,111,0.96,1
2,703,1,13,6,19,1.0,0
2,703,1,6,0,6,0.0,0
3,260,2,2,1,3,1.0,1
3,537,1,22,0,22,1.0,0
3,665,6,22,15,37,1.0,1
4,403,116,1152,478,1630,0.6876971608832808,1
4,794,1,2,5,7,1.0,0
5,820,1,3,1,4,1.0,0
5,829,3,132,5,137,0.136986301369863,0
5,835,1,14,9,23,1.0,1
5,940,26,320,216,536,0.3389830508474576,1
6,337,2,11,7,18,0.0,0
6,538,6,217,11,228,1.0,0
6,728,6,50,6,56,0.8181818181818182,0
6,730,1,5,1,6,1.0,0
6,755,1,80,22,102,1.0,0
6,756,11,59,21,80,1.0,0
6,944,10,81,21,102,1.0,1
1,137,163,4275,2965,7240,0.9715808170515098,1
1,295,53,725,360,1085,0.943502824858757,1
1,358,10,25,24,49,0.0,0
1,733,9,54,36,90,1.0,0
2,175,5,23,10,33,1.0,1
2,570,5,111,59,170,0.0,0
2,719,16,337,239,576,0.8611111111111112,1
2,935,13,69,49,118,0.7142857142857143,1
3,290,1,14,0,14,1.0,0
3,414,2,130,10,140,0.9375,0
3,770,49,409,134,543,1.0,0
4,222,9,82,73,155,1.0,0
4,372,1,8,0,8,1.0,0
4,407,113,1826,741,2567,1.0,1
4,560,1,8,4,12,1.0,0
4,746,3,10,2,12,1.0,0
5,176,1,11,3,14,0.0,1
5,596,5,61,44,105,0.0,0
5,879,2,25,0,25,1.0,0
0,661,2,3,22,25,1.0,0
0,844,2,14,7,21,1.0,0
0,901,15,122,18,140,0.0,0
0,901,2,7,3,10,1.0,0
0,915,4,27,19,46,1.0,0
1,980,2,10,20,30,0.0,0
1,983,3,66,3,69,0.3469387755102041,0
1,943,4,12,2,14,1.0,0
1,945,1,9,13,22,0.0,1
1,946,3,284,2,286,1.0,0
1,949,1,98,23,121,1.0,0
1,950,3,11,6,17,1.0,0
1,957,2,39,16,55,1.0,0
2,963,2,30,13,43,1.0,0
2,964,2,27,11,38,0.75,0
2,968,3,35,12,47,0.0,0
2,969,7,57,14,71,1.0,0
2,409,4,10,1,11,1.0,0
2,500,2,75,21,96,0.9166666666666666,0
3,203,1,15,4,19,1.0,0
3,211,1,66,0,66,1.0,0
3,212,3,136,38,174,0.3125,1
3,433,2,31,7,38,0.9375,1
3,513,10,1018,0,1018,0.3654545454545455,0
3,556,28,471,256,727,0.7802197802197802,0
3,562,1,4,2,6,0.0,0
3,577,1,24,26,50,0.0,0
3,578,31,213,106,319,0.7910447761194029,1
3,588,2,10,2,12,0.0,0
4,182,1,1,0,1,1.0,0
4,210,2,1,4,5,0.5,0
4,305,1,8,3,11,0.0,0
4,306,1,12,9,21,0.0,0
4,374,35,1406,134,1540,0.8323108384458078,1
4,392,1,10,1,11,1.0,0
4,418,1,1,0,1,1.0,0
4,579,4,81,10,91,1.0,1
4,585,1,5,2,7,1.0,0
5,210,1,170,25,195,1.0,0
6,222,2,3,0,3,1.0,0
6,669,6,245,1,246,1.0,0
6,690,4,19,8,27,1.0,0
0,134,21,539,124,663,0.9770642201834863,1
0,195,2,7,18,25,0.6,0
0,229,1,10,16,26,0.0,0
0,680,2,29,25,54,1.0,0
0,703,3,88,9,97,1.0,0
0,712,2,10,4,14,1.0,0
0,720,1,114,0,114,1.0,0
1,178,30,751,179,930,0.6122448979591837,1
1,378,7,72,24,96,0.0,0
2,132,1,1,7,8,0.0,0
3,113,1,14,20,34,1.0,1
3,113,2,15,4,19,0.7777777777777778,0
3,132,2,97,29,126,1.0,0
3,137,9,251,16,267,1.0,0
3,139,3,46,1,47,1.0,0
3,151,1,13,0,13,1.0,0
3,390,3,138,119,257,0.0,0
4,65,2,355,43,398,0.5822784810126582,0
5,993,2,13,4,17,1.0,0
5,23,12,471,132,603,1.0,0
4,166,17,5602,2431,8033,0.7916666666666666,0
4,192,1,13,0,13,1.0,0
4,220,1,13,2,15,0.0,0
4,433,1,58,59,117,0.0,0
4,589,11,204,89,293,1.0,1
5,180,3,11,2,13,1.0,0
5,443,2,17,7,24,0.0,1
5,468,1,19,1,20,1.0,0
5,478,2,15,10,25,0.0,0
5,480,2,5,5,10,0.0,0
5,483,1,4,4,8,1.0,1
5,505,5,241,63,304,1.0,0
6,568,4,21,7,28,0.0,0
0,203,1,0,5,5,0.0,0
0,204,20,352,16,368,0.8931297709923665,1
0,500,1,25,26,51,1.0,0
0,585,3,60,49,109,0.3333333333333333,0
1,161,3,71,16,87,1.0,1
1,163,1,11,3,14,0.0,0
1,163,1,6,3,9,1.0,0
1,164,3,8,6,14,1.0,0
0,167,1,20,7,27,1.0,0
1,316,2,11,6,17,1.0,0
1,362,3,36,41,77,0.0,1
1,478,4,97,6,103,1.0,0
2,183,21,213,96,309,1.0,0
2,459,8,166,256,422,1.0,0
2,462,11,73,92,165,0.0,0
2,464,20,644,2808,3452,0.4472049689440994,1
2,465,1,3,1,4,0.0,0
2,473,3,14,1,15,1.0,0
2,671,1,23,16,39,0.0,0
3,103,3,20,10,30,1.0,1
3,524,6,188,6,194,1.0,0
3,527,9,813,48,861,1.0,1
4,442,1,3,1,4,1.0,0
6,862,3,83,16,99,1.0,0
0,158,22,386,239,625,1.0,1
0,221,20,149,163,312,0.0,0
0,730,2,38,10,48,0.875,0
1,131,139,2556,771,3327,0.8831615120274914,1
2,667,12,99,51,150,0.26666666666666666,1
3,187,36,1116,138,1254,1.0,1
3,194,9,277,13,290,0.99,0
3,198,1,9,0,9,1.0,0
3,205,1,3,1,4,1.0,0
3,206,1,54,53,107,1.0,0
3,213,1,1,3,4,0.0,0
3,383,23,954,612,1566,1.0,1
5,873,19,121,27,148,1.0,0
0,278,2,99,41,140,0.6111111111111112,0
0,289,5,120,18,138,1.0,1
0,294,11,276,69,345,1.0,0
0,303,1,5,2,7,1.0,0
0,398,26,695,628,1323,0.0,1
1,441,1,3,1,4,1.0,0
2,381,12,66,100,166,0.0,0
2,442,2,24,3,27,0.9411764705882353,0
2,470,15,561,296,857,0.5454545454545454,1
2,488,5,53,11,64,0.7931034482758621,0
2,499,1,16,5,21,0.0,0
2,531,1,12,16,28,1.0,0
2,548,4,113,6,119,1.0,0
2,563,6,137,62,199,1.0,0
2,706,3,13,134,147,0.7894736842105263,1
2,740,3,10,4,14,1.0,1
3,359,6,38,6,44,0.9,0
4,52,10,108,10,118,0.34328358208955223,0
4,167,31,584,203,787,0.6008064516129032,1
4,174,12,475,16,491,0.9086021505376344,0
3,182,4,125,52,177,1.0,0
5,143,3,46,13,59,1.0,0
5,147,3,60,11,71,0.775,0
5,148,3,80,27,107,1.0,0
6,10,2,23,16,39,1.0,0
6,433,1,6,0,6,1.0,0
6,447,3,7,57,64,0.023809523809523808,0
6,151,15,524,86,610,0.8206896551724138,0
0,660,5,121,15,136,1.0,0
1,230,1,4,0,4,0.0,0
2,168,1,27,25,52,1.0,0
2,177,1,23,15,38,1.0,0
2,179,5,122,47,169,0.32558139534883723,0
2,193,41,2129,413,2542,0.8367729831144465,1
2,198,4,23,34,57,0.0,0
3,102,3,5,3,8,1.0,0
3,465,4,17,10,27,1.0,1
3,468,2,29,14,43,1.0,0
3,534,10,291,49,340,0.7419354838709677,1
3,536,2,11,15,26,0.0,0
3,537,13,62,38,100,1.0,0
3,541,10,383,112,495,1.0,0
3,541,2,25,8,33,0.7272727272727273,0
3,542,2,2,7,9,0.0,0
3,543,1,24,10,34,0.0,0
3,547,4,142,80,222,0.16216216216216217,0
4,168,15,534,21,555,1.0,0
4,497,1,14,6,20,1.0,0
5,430,1,6,0,6,1.0,0
5,430,2,7,2,9,1.0,0
5,455,3,39,12,51,0.21739130434782608,0
5,472,2,6,8,14,0.0,0
5,619,166,2301,2120,4421,0.0,0
6,427,2,15,1,16,1.0,0
0,160,1,3,0,3,1.0,0
0,327,2,6,10,16,0.0,0
0,563,9,184,136,320,1.0,1
1,169,1,37,48,85,0.0,0
1,180,9,0,328,328,0.0,0
1,411,1,16,15,31,0.0,0
2,283,2,17,9,26,0.7142857142857143,0
2,335,2,80,18,98,0.7222222222222222,0
5,407,13,579,0,579,1.0,0
2,519,1,3,1,4,0.0,0
2,725,27,200,475,675,0.0,0
3,728,1,13,14,27,0.0,1
3,737,11,390,236,626,1.0,0
3,738,1,25,15,40,1.0,0
3,744,4,148,3,151,0.9183673469387755,0
3,750,1,42,3,45,0.5238095238095238,1
3,818,2,19,4,23,0.6,0
3,821,32,730,295,1025,1.0,1
3,828,1,12,16,28,0.0,0
3,842,11,231,41,272,0.4634146341463415,0
3,847,19,703,23,726,1.0,0
3,867,11,1065,30,1095,1.0,0
6,475,43,482,1207,1689,0.20175438596491227,1
3,226,22,200,2,202,1.0,0
6,512,16,686,30,716,1.0,0
6,519,4,53,17,70,0.6111111111111112,0
6,524,18,430,35,465,1.0,1
6,912,1,6,0,6,1.0,0
6,915,1,35,31,66,1.0,0
6,916,1,0,35,35,0.0,0
6,943,3,18,5,23,0.7,1
2,125,8,67,31,98,1.0,0
3,671,1,10,2,12,1.0,0
0,136,4,14,14,28,0.0,0
0,331,1,0,2,2,1.0,0
0,333,8,72,93,165,0.0,0
0,334,4,328,6,334,1.0,0
1,489,2,10,5,15,0.5,0
4,130,3,50,1,51,0.926829268292683,0
4,130,1,2,0,2,1.0,0
4,795,5,22,7,29,1.0,0
6,435,6,134,28,162,0.7066666666666667,1
6,541,3,34,9,43,0.0,1
6,639,1,6,0,6,0.0,0
6,901,3,25,10,35,1.0,1
0,144,14,143,2,145,0.9302325581395349,0
0,346,1,2,1,3,0.0,0
0,838,1,6,2,8,0.0,0
0,946,4,19,14,33,1.0,0
1,212,7,12,9,21,1.0,0
2,380,2,5,2,7,1.0,0
2,382,16,173,62,235,0.8793103448275862,1
2,413,13,290,36,326,0.31137724550898205,0
2,380,2,5,2,7,1.0,0
3,399,4,138,5,143,1.0,0
3,423,11,198,5,203,0.9622641509433962,0
0,340,7,30,22,52,1.0,0
0,377,5,10,9,19,1.0,0
0,379,3,12,7,19,1.0,0
1,957,11,29,28,57,1.0,0
2,967,32,298,346,644,0.9516129032258065,0
2,231,5,48,11,59,0.17647058823529413,0
3,147,49,2279,2425,4704,0.0,1
3,325,2,30,27,57,0.0,0
3,407,17,0,3893,3893,0.4861244019138756,0
3,408,2,5,1,6,1.0,0
3,582,1,12,3,15,1.0,0
4,410,1,9,1,10,1.0,0
5,744,28,610,98,708,0.850909090909091,1
6,566,9,72,81,153,1.0,1
0,318,71,695,348,1043,1.0,1
0,445,3,68,59,127,1.0,0
0,476,2,44,20,64,1.0,0
0,480,31,687,418,1105,0.3575757575757576,0
0,481,23,814,7,821,0.8379888268156425,1
2,176,603,5477,10466,15943,0.06367041198501873,1
2,585,22,691,27,718,0.5802919708029197,0
3,564,4,12,13,25,0.0,1
4,213,2,15,2,17,0.25,0
4,214,3,38,16,54,0.0,0
5,936,4,28,20,48,1.0,0
1,470,4,43,6,49,0.875,0
1,724,20,44,312,356,0.0,1
3,452,2,36,1,37,1.0,0
3,888,1,1,0,1,0.0,0
4,345,4,53,85,138,0.058823529411764705,0
0,119,5,30,16,46,0.14285714285714285,0
0,196,10,110,31,141,0.014925373134328358,0
3,416,6,19,54,73,0.0,0
6,527,9,50,27,77,1.0,0
6,528,8,58,65,123,0.125,0
6,534,2,43,35,78,1.0,0
6,538,4,18,3,21,1.0,0
6,543,9,442,38,480,0.31140350877192985,1
6,551,4,41,30,71,1.0,0
4,461,1,4,0,4,0.0,0
2,168,3,148,114,262,1.0,0
2,220,4,9,15,24,0.75,0
2,220,4,171,8,179,0.28703703703703703,1
4,220,1,3,0,3,1.0,0
5,413,5,42,9,51,1.0,1
5,415,7,60,18,78,0.7857142857142857,1
5,426,2,20,16,36,1.0,0
5,468,26,545,576,1121,1.0,1
6,237,2,114,4,118,1.0,0
6,249,2,79,10,89,1.0,0
6,264,1,4,1,5,0.0,0
6,272,5,44,39,83,1.0,0
6,272,1,15,6,21,1.0,0
1,137,17,401,158,559,1.0,1
3,858,1,4,2,6,1.0,0
4,119,2,30,3,33,0.0,0
4,371,21,81,99,180,0.42857142857142855,0
3,348,2,4,5,9,1.0,0
3,524,1,4,2,6,1.0,1
4,176,2,50,10,60,1.0,0
4,537,1,6,0,6,1.0,0
4,540,1,6,3,9,0.0,0
0,323,3,23,5,28,0.7333333333333333,0
0,734,5,28,45,73,1.0,0
2,125,48,1099,652,1751,0.5875,1
2,126,2,28,5,33,0.7368421052631579,0
4,527,3,15,21,36,0.0,0
4,531,2,12,0,12,0.8888888888888888,0
0,251,2,0,12,12,0.1111111111111111,0
0,431,3,17,4,21,0.0,0
1,273,119,4680,5023,9703,0.03298350824587706,1
2,462,3,65,27,92,1.0,0
0,162,6,206,8,214,1.0,0
0,448,3,64,10,74,1.0,0
0,486,2,2,4,6,1.0,0
3,547,14,325,17,342,1.0,0
3,550,8,47,261,308,0.0,0
4,431,13,111,17,128,0.9473684210526315,0
0,416,1,3,0,3,1.0,0
0,638,1,1,0,1,0.0,0
1,123,10,78,39,117,0.03571428571428571,0
1,234,2,49,5,54,0.0,0
1,247,6,57,18,75,0.9565217391304348,1
1,384,7,49,18,67,0.0,0
1,407,5,19,12,31,0.5,0
1,479,5,25,8,33,1.0,0
1,481,2,8,2,10,1.0,0
1,484,1,1,2,3,0.0,0
1,572,4,21,76,97,0.0,0
2,416,3,425,0,425,0.6282527881040892,1
2,418,4,21,9,30,0.0,1
2,458,2,16,6,22,0.0,0
2,529,1,6,1,7,0.0,0
2,540,1,1,0,1,0.0,0
3,382,1,1,7,8,1.0,0
3,409,17,328,88,416,1.0,0
6,431,25,529,218,747,0.9672131147540983,0
1,202,1,2,10,12,0.0,0
2,161,1,2,1,3,0.0,0
2,296,5,26,11,37,1.0,0
4,180,5,43,11,54,1.0,1
6,170,137,6044,3030,9074,0.7330383480825958,1
0,226,33,57,55,112,0.0,0
0,571,1,21,3,24,0.0,0
1,414,2,17,11,28,1.0,0
1,548,1,23,4,27,0.0,0
2,231,1,0,8,8,1.0,0
3,109,24,183,57,240,1.0,1
3,539,1,0,2,2,1.0,0
3,572,43,2002,1571,3573,0.6148648648648649,1
3,845,1,3,2,5,0.0,0
5,799,3,73,36,109,0.7419354838709677,1
2,179,1,15,2,17,0.0,0
3,348,2,30,8,38,0.625,0
4,256,4,6,5,11,1.0,0
4,433,4,88,8,96,1.0,0
1,232,1,3,1,4,0.0,0
2,534,1,0,7,7,1.0,0
3,154,1,12,8,20,1.0,0
3,184,1,2,1,3,1.0,0
3,217,3,18,9,27,1.0,0
5,72,3,7,4,11,0.5,0
0,385,1,3,2,5,0.0,0
1,261,3,19,33,52,0.25,1
1,502,1,6,0,6,1.0,0
2,492,6,140,1,141,1.0,0
2,524,8,217,81,298,0.8059701492537313,1
2,552,6,158,1,159,1.0,0
2,593,2,29,1,30,0.75,0
3,328,1,4,3,7,1.0,0
4,437,7,67,105,172,0.0,0
4,444,1,1,9,10,0.0,0
4,860,1,10,8,18,1.0,0
0,107,2,16,0,16,1.0,0
1,767,2,78,7,85,1.0,0
5,360,3,46,38,84,1.0,0
5,457,1,18,4,22,1.0,0
5,490,1,2,4,6,0.0,1
5,492,2,8,10,18,0.0,0
5,586,9,69,5,74,1.0,0
0,122,2,12,3,15,1.0,0
1,99,15,466,74,540,0.7611111111111111,1
1,100,3,59,12,71,1.0,0
1,166,3,14,7,21,0.0,0
3,357,2,54,13,67,0.47058823529411764,0
3,477,2,16,3,19,0.0,0
0,483,2,37,5,42,1.0,0
2,555,1,3,1,4,1.0,0
3,315,1,5,2,7,0.0,0
3,759,13,63,59,122,1.0,0
6,62,1,12,11,23,0.0,0
1,402,3,178,58,236,1.0,0
0,496,4,28,6,34,0.4117647058823529,0
2,379,2,15,5,20,1.0,0
3,525,34,2587,0,2587,0.9245283018867925,1
3,654,6,205,6,211,0.5662650602409639,1
4,146,3,144,59,203,0.7222222222222222,0
4,386,2,27,27,54,0.0,0
6,884,1,6,0,6,1.0,0
6,886,3,145,20,165,1.0,0
0,113,4,13,6,19,1.0,0
0,151,1,23,2,25,1.0,0
0,196,2,10,2,12,0.0,1
0,383,6,136,206,342,1.0,0
0,384,23,474,67,541,0.5950920245398773,0
0,612,5,50,42,92,1.0,0
2,485,5,126,11,137,0.5882352941176471,0
2,580,19,226,120,346,1.0,0
3,414,65,879,581,1460,0.6901408450704225,0
4,381,2,53,31,84,0.0,0
4,381,12,155,29,184,1.0,1
4,387,5,225,58,283,1.0,0
0,116,1,2,5,7,0.0,0
0,121,7,235,7,242,1.0,1
0,149,2,22,0,22,1.0,0
0,151,1,26,9,35,1.0,0
0,542,1,8,1,9,1.0,0
4,387,3,14,11,25,0.3333333333333333,0
4,702,1,4,11,15,0.0,0
0,196,20,69,84,153,0.7272727272727273,0
1,707,1,0,3,3,0.0,0
2,379,8,500,30,530,0.8130841121495327,0
3,759,1,73,61,134,1.0,0
3,769,2,29,97,126,0.0,0
3,770,1,12,4,16,0.0,0
4,377,1,19,20,39,0.0,0
4,379,1,7,3,10,1.0,0
4,379,4,121,76,197,0.0,0
0,97,1,5,2,7,1.0,0
0,505,4,96,62,158,1.0,1
0,709,1,39,1,40,0.3,0
1,566,1,6,2,8,1.0,0
2,144,1,24,19,43,1.0,0
2,380,1,14,35,49,0.5384615384615384,0
0,97,1,5,2,7,1.0,0
0,709,1,39,1,40,0.3,0
1,566,1,6,2,8,1.0,0
2,144,1,24,19,43,1.0,0
2,380,1,14,35,49,0.5384615384615384,0
4,188,6,24,43,67,0.5,0
6,745,6,320,0,320,1.0,0
0,105,4,60,95,155,1.0,0
0,108,3,5,7,12,0.0,0
0,436,1,1,0,1,0.0,0
0,470,1,5,5,10,0.0,0
1,196,11,49,79,128,1.0,0
1,197,6,29,33,62,0.14285714285714285,0
1,335,3,49,12,61,0.037037037037037035,0
2,578,22,209,272,481,0.8,0
3,583,15,1212,244,1456,0.8389694041867954,0
4,74,2,13,1,14,0.375,1
4,82,29,241,176,417,1.0,1
4,138,67,905,42,947,0.902542372881356,0
4,452,50,1334,5,1339,0.7272727272727273,1
6,261,1,0,3,3,1.0,0
6,348,3,61,22,83,0.125,0
6,782,4,31,38,69,0.25,0
1,175,7,120,9,129,0.5116279069767442,0
1,751,1,3,7,10,0.0,0
1,754,2,26,0,26,1.0,0
1,766,8,56,25,81,0.2727272727272727,0
4,115,2,8,12,20,0.0,0
4,239,27,551,157,708,0.9878048780487805,1
4,551,16,79,39,118,0.07142857142857142,0
0,78,12,62,26,88,0.6,0
0,132,1,6,1,7,0.0,0
1,76,1,7,2,9,0.0,0
2,182,1,7,2,9,0.0,0
2,197,4,51,5,56,1.0,0
2,560,11,55,38,93,0.4166666666666667,0
2,561,6,25,12,37,0.8571428571428571,0
2,571,2,37,1,38,1.0,0
3,208,4,262,4,266,0.6510067114093959,0
0,170,14,196,16,212,0.3582089552238806,0
0,181,9,127,14,141,0.9863013698630136,1
0,184,7,668,0,668,0.7361963190184049,0
0,391,10,75,26,101,0.3333333333333333,0
0,393,3,50,56,106,0.375,0
0,401,8,161,46,207,0.9753086419753086,0
1,575,1,0,3,3,0.0,0
2,368,3,15,34,49,1.0,0
3,450,6,48,7,55,1.0,0
3,744,5,15,5,20,1.0,0
6,152,1,5,1,6,0.0,0
6,155,8,148,18,166,0.9069767441860465,0
0,582,4,53,8,61,0.0,0
1,115,1,1,2,3,0.0,0
1,115,3,26,39,65,0.0,0
1,304,1,9,9,18,0.0,0
1,315,1,3,1,4,0.0,0
1,819,10,200,21,221,0.509090909090909,0
2,377,1,2,2,4,0.0,0
3,234,1,1,2,3,0.0,0
3,235,2,70,10,80,0.5476190476190477,0
3,235,1,2,0,2,1.0,0
4,398,3,28,49,77,0.9166666666666666,0
4,455,6,124,93,217,1.0,1
6,160,11,197,47,244,0.5238095238095238,0
6,170,1,5,0,5,1.0,0
6,792,1,10,2,12,1.0,0
0,104,5,15,4,19,1.0,0
0,107,8,266,2,268,0.6633663366336634,0
0,116,2,19,1,20,1.0,0
0,118,7,241,2,243,1.0,0
0,124,1,20,3,23,0.0,0
0,164,24,1517,11,1528,1.0,1
0,484,3,39,0,39,1.0,0
1,105,1,0,1,1,0.0,0
1,516,3,140,22,162,0.5694444444444444,1
1,579,1,2,1,3,1.0,0
2,503,2,56,0,56,0.22857142857142856,0
2,808,2,130,18,148,1.0,0
2,823,1,12,4,16,1.0,0
0,488,2,35,7,42,0.7777777777777778,0
2,130,2,127,0,127,1.0,0
2,154,38,396,256,652,0.9506172839506173,0
3,458,9,106,41,147,0.36363636363636365,0
3,461,1,9,3,12,1.0,0
5,98,2,16,3,19,0.0,0
5,106,27,1644,3,1647,0.9565217391304348,0
5,547,6,51,1,52,0.875,0
6,136,12,112,315,427,1.0,0
6,846,12,1023,1,1024,0.7755555555555556,0
3,101,9,404,18,422,1.0,0
3,106,1,6,8,14,1.0,0
3,107,10,55,53,108,1.0,0
4,120,1,8,15,23,1.0,0
4,180,1,2,3,5,0.0,0
4,183,1,2,3,5,0.0,0
4,594,1,5,17,22,0.0,0
5,374,12,192,96,288,0.631578947368421,0
5,400,1,3,6,9,0.0,0
2,471,3,18,17,35,0.0,0
2,575,1,4,2,6,0.0,0
3,128,9,181,23,204,1.0,0
3,163,3,19,9,28,0.0,0
4,200,1,3,9,12,1.0,0
4,203,8,52,24,76,1.0,0
4,205,2,13,1,14,0.0,0
4,423,2,79,3,82,0.42,0
6,849,12,534,147,681,1.0,0
2,227,2,4,0,4,0.0,0
2,375,11,156,13,169,0.5714285714285714,0
3,366,1,15,3,18,0.0,0
3,387,1,1,2,3,0.0,0
3,389,8,49,15,64,0.0,0
3,410,1,16,23,39,1.0,0
4,26,4,449,366,815,0.9411764705882353,0
0,391,52,387,123,510,1.0,1
0,398,16,284,26,310,0.6513761467889908,0
0,407,1,14,5,19,0.0,0
0,431,3,10,1,11,0.375,0
1,436,2,47,4,51,0.0,0
1,447,2,11,2,13,1.0,1
1,495,3,38,1,39,0.6111111111111112,0
1,495,8,54,29,83,0.625,0
1,497,1,9,4,13,1.0,1
2,450,1,5,11,16,0.0,0
0,640,1,9,1,10,1.0,0
4,381,2,15,1,16,0.6666666666666666,0
4,400,6,56,9,65,0.75,0
6,68,9,23,181,204,0.0,0
0,148,1,29,94,123,1.0,0
0,673,1,12,1,13,1.0,0
1,154,6,60,9,69,1.0,0
3,125,1,8,2,10,1.0,0
3,127,1,3,0,3,1.0,0
3,163,3,24,2,26,0.0,0
4,155,5,25,10,35,1.0,0
4,359,8,79,8,87,0.25,0
5,488,2,12,14,26,0.75,0
0,193,8,107,16,123,0.8852459016393442,0
2,140,2,39,32,71,1.0,0
2,146,29,248,145,393,0.0,0
1,1432,117,1097,809,1906,1.0,0
2,187,2,14,2,16,1.0,0
2,297,3,27,21,48,1.0,0
3,1407,5,66,2,68,0.5192307692307693,0
6,553,3,60,2,62,1.0,0
1,214,4,125,11,136,0.8787878787878788,0
2,128,1,5,1,6,0.0,0
3,146,1,2,0,2,1.0,0
5,399,15,1315,126,1441,0.32171581769436997,0
5,476,4,100,55,155,0.0,1
5,583,4,15,8,23,0.0,0
1,146,4,14,10,24,0.0,0
1,157,6,10,54,64,0.18181818181818182,0
0,155,4,5,194,199,0.0449438202247191,0
6,68,9,23,181,204,0.0,0
0,211,9,181,23,204,1.0,0
0,231,1,44,16,60,1.0,0
1,168,64,321,314,635,1.0,0
1,185,190,1245,1231,2476,1.0,0
1,364,8,97,14,111,1.0,0
1,422,1,11,2,13,0.0,0
1,506,1,7,7,14,0.0,0
1,556,1,33,31,64,0.0,0
4,574,28,246,199,445,1.0,0
5,615,7,185,93,278,1.0,0
0,87,2,34,0,34,0.0,0
0,364,9,767,112,879,1.0,0
0,536,4,12,20,32,0.0,0
1,418,7,77,17,94,1.0,0
1,707,2,14,3,17,1.0,0
1,710,14,387,226,613,1.0,0
2,414,12,255,112,367,0.9775280898876404,0
3,607,1,2,0,2,0.0,0
0,236,14,263,29,292,0.8611111111111112,0
0,457,25,371,159,530,0.9125,0
2,731,1,19,22,41,1.0,0
3,484,1,3,1,4,1.0,0
3,586,5,54,11,65,1.0,0
