day,time,numberOfModifiedFiles,insertions,deletions,totalLines,complexity,badCommit
3,1304,93,2215,0,2215,0.12673267326732673,0
4,75,2,261,286,547,1.0,0
4,1103,1,2,1,3,0.0,0
3,1359,1,111,4,115,0.2828282828282828,0
4,1188,8,114,113,227,0.75,0
6,385,1,11,14,25,1.0,0
6,421,1,3,1,4,0.0,0
4,779,4,76,4,80,1.0,0
5,1051,10,174,274,448,1.0,0
5,871,1,1,0,1,1.0,0
6,424,1,39,1,40,1.0,0
2,1419,7,43,55,98,1.0,0
